шон	шонг	N;ACC;SG
заан	зааны	N;GEN;SG
ахиц	ахицаас	N;ABL;SG
үүсэл	үүслээр	N;INS;SG
эдэлгээ	эдэлгээнээс	N;ABL;SG
хими	химийн	N;GEN;SG
зүүлт	зүүлтийг	N;ACC;SG
нягтаршил	нягтаршлаас	N;ABL;SG
гагнуурчин	гагнуурчнаар	N;INS;SG
гуя	гуяаа	N;VOC;SG
царай	царайг	N;ACC;SG
титэм	титмийн	N;GEN;SG
гүзээлзгэнэ	гүзээлзгэнээс	N;ABL;SG
зуун	зууны	N;GEN;SG
судар	судраас	N;ABL;SG
шүлэгч	шүлэгчээр	N;INS;SG
геологи	геологийг	N;ACC;SG
сүсэг	сүсгийн	N;GEN;SG
касс	кассны	N;GEN;SG
судлаач	судлаачаа	N;VOC;SG
бичилт	бичилтийн	N;GEN;SG
эшлэл	эшлэлээ	N;VOC;SG
исэлдэлт	исэлдэлтийг	N;ACC;SG
пальто	пальтог	N;ACC;SG
чих	чихээ	N;VOC;SG
саатал	саатлаа	N;VOC;SG
үсрэлт	үсрэлтээ	N;VOC;SG
хөрөөдөх	өвөрлөчих	V;IMP;SG+PL;2
загас	загасаа	N;VOC;SG
зэвүүцэл	зэвүүцлээс	N;ABL;SG
нэмэгдэл	нэмэгдлээс	N;ABL;SG
чийг	чийгээ	N;VOC;SG
уцаар	уцаарын	N;GEN;SG
оюутан	оюутнаар	N;INS;SG
байлдаан	байлдаанаа	N;VOC;SG
бүлүүр	бүлүүрээ	N;VOC;SG
арга	аргаас	N;ABL;SG
үнэлэлт	үнэлэлтийг	N;ACC;SG
шүүр	шүүрээр	N;INS;SG
гүжирдлэг	гүжирдлэгээ	N;VOC;SG
мөхөл	мөхлөөр	N;INS;SG
эвлэрэл	эвлэрлээс	N;ABL;SG
зарга	заргаар	N;INS;SG
эвдчих	эвдэчвэл	V.CVB;LGSPEC03
зугаалга	зугаалгыг	N;ACC;SG
хянагч	хянагчийг	N;ACC;SG
он	оны	N;GEN;SG
маркетинг	маркетингаас	N;ABL;SG
хэвлэгч	хэвлэгчийг	N;ACC;SG
ялгаа	ялгаанаас	N;ABL;SG
эзэмшил	эзэмшлийг	N;ACC;SG
хараа	харааны	N;GEN;SG
хотжих	хотжицгоо	V;IMP;PL;2;PRS
хэрэгтэй	хэргээ	N;VOC;SG
бохь	бохины	N;GEN;SG
нөхөөс	нөхөөсөө	N;VOC;SG
гадаргуу	гадаргууг	N;ACC;SG
жигшил	жигшлийг	N;ACC;SG
гөлөг	гөлгийг	N;ACC;SG
билет	билетийг	N;ACC;SG
хүүхэлдэй	хүүхэлдэйгээ	N;VOC;SG
хөлслөгч	хөлслөгчийн	N;GEN;SG
ялгадас	ялгадаснаас	N;ABL;SG
сэдэгч	сэдэгчээс	N;ABL;SG
арьс	арьснаас	N;ABL;SG
жолооч	жолоочийн	N;GEN;SG
хурдатгал	хурдатгалаар	N;INS;SG
олс	олсноос	N;ABL;SG
боржин	боржингийн	N;GEN;SG
нэгтгэл	нэгтгэлээр	N;INS;SG
маск	маскаас	N;ABL;SG
ирвэгэнэх	хэлмэгдэцгээ	V;IMP;PL;2;PRS
дэн	дэнг	N;ACC;SG
гялгар	гялгараас	N;ABL;SG
маажин	маажингаас	N;ABL;SG
мужаан	мужаанаа	N;VOC;SG
фермент	ферментээр	N;INS;SG
идэгдэл	идэгдлээс	N;ABL;SG
цуглаан	цуглаанаа	N;VOC;SG
хэрэм	хэрмээ	N;VOC;SG
залгамжлал	залгамжлалын	N;GEN;SG
бодолт	бодолтоор	N;INS;SG
бүрдэл	бүрдлээр	N;INS;SG
хувилбар	хувилбараас	N;ABL;SG
солбицох	солбицоцгоо	V;IMP;PL;2;PRS
ойлт	ойлтын	N;GEN;SG
хувьсгагч	хувьсгагчийг	N;ACC;SG
реализм	реализмаас	N;ABL;SG
тэврэлт	тэврэлтээр	N;INS;SG
хагацал	хагацлаа	N;VOC;SG
дэмжигч	дэмжигчийг	N;ACC;SG
хараа	хараагаа	N;VOC;SG
тэмтрэх	тэмтэрчээ	V;IND;PST
уул	уулыг	N;ACC;SG
ялгавар	ялгаврыг	N;ACC;SG
өвгөн	өвгөнөө	N;VOC;SG
цулбуур	цулбуурын	N;GEN;SG
арбитр	арбитрын	N;GEN;SG
ёроол	ёроолыг	N;ACC;SG
дүүргэлт	дүүргэлтээ	N;VOC;SG
тагнуул	тагнуулаас	N;ABL;SG
шалтгаан	шалтгаанаар	N;INS;SG
чадвар	чадварыг	N;ACC;SG
гудас	гудаснаас	N;ABL;SG
арбитр	арбитраар	N;INS;SG
харуусал	харууслаас	N;ABL;SG
санаачлагч	санаачлагчаас	N;ABL;SG
халаас	халааснаас	N;ABL;SG
прокурор	прокуророо	N;VOC;SG
цацаг	цацгийг	N;ACC;SG
зэрэг	зэргийн	N;GEN;SG
хугацаа	хугацааны	N;GEN;SG
тоос	тоосыг	N;ACC;SG
дараа	дарааны	N;GEN;SG
симфони	симфонийг	N;ACC;SG
тосгуур	тосгуурын	N;GEN;SG
зүхэл	зүхлээ	N;VOC;SG
хөрөг	хөргөөс	N;ABL;SG
үгүйсгэл	үгүйсгэлээ	N;VOC;SG
хэсэг	хэсгээр	N;INS;SG
хонх	хонхыг	N;ACC;SG
ургийнхан	ургийг	N;ACC;SG
үндэслэл	үндэслэлийн	N;GEN;SG
зорчигч	зорчигчийн	N;GEN;SG
радио	радиогоос	N;ABL;SG
нэмэгдэл	нэмэгдлийн	N;GEN;SG
сэжиг	сэжгийн	N;GEN;SG
хасалт	хасалтын	N;GEN;SG
сурагч	сурагчийг	N;ACC;SG
хуйлаас	хуйлаасны	N;GEN;SG
тойрог	тойргийг	N;ACC;SG
урвагч	урвагчаас	N;ABL;SG
суваг	сувгийн	N;GEN;SG
сонгино	сонгиноос	N;ABL;SG
төлөөс	төлөөсөөр	N;INS;SG
хадгалалт	хадгалалтаа	N;VOC;SG
буурь	бууриар	N;INS;SG
хадуур	хадуурын	N;GEN;SG
тоншуул	тоншуулаа	N;VOC;SG
нөмрөг	нөмрөгөөс	N;ABL;SG
батга	батгаа	N;VOC;SG
төрөх	төрцгөө	V;IMP;PL;2;PRS
авгалдай	авгалдайгаар	N;INS;SG
хатаагуур	хатаагуураа	N;VOC;SG
бэрх	бэрхээр	N;INS;SG
зангилаа	зангилаанаас	N;ABL;SG
ширэнгэ	ширэнгээр	N;INS;SG
барих	барьцгаа	V;IMP;PL;2;PRS
бай	байгаа	N;VOC;SG
хатаагч	хатаагчийг	N;ACC;SG
өгөгдөл	өгөгдлийн	N;GEN;SG
хуримтлал	хуримтлалаа	N;VOC;SG
гэрээ	гэрээнээс	N;ABL;SG
доллар	долларын	N;GEN;SG
шураг	шургаа	N;VOC;SG
төлөөлөгч	төлөөлөгчөөр	N;INS;SG
хөлөг	хөлгийг	N;ACC;SG
эргэцүүлэл	эргэцүүллээс	N;ABL;SG
дэмжигч	дэмжигчээр	N;INS;SG
ёсолгоо	ёсолгоогоор	N;INS;SG
төрөх	төрвөл	V.CVB;LGSPEC03
зааг	заагаар	N;INS;SG
керамик	керамикаар	N;INS;SG
буртаг	буртгаас	N;ABL;SG
хөрөөдөх	хөрөөдөцгөө	V;IMP;PL;2;PRS
холбоос	холбоосноос	N;ABL;SG
ёсолгоо	ёсолгооноос	N;ABL;SG
үсчин	үсчнийг	N;ACC;SG
луйварчин	луйварчнаа	N;VOC;SG
театр	театраас	N;ABL;SG
суваг	сувгаа	N;VOC;SG
шинжлэгч	шинжлэгчээс	N;ABL;SG
гоймон	гоймонгоор	N;INS;SG
чансаа	чансааг	N;ACC;SG
шаналал	шаналлаас	N;ABL;SG
хурдасгуур	хурдасгуураар	N;INS;SG
тоос	тоосноос	N;ABL;SG
дайсан	дайсны	N;GEN;SG
хотжилт	хотжилтоор	N;INS;SG
зураглал	зураглалыг	N;ACC;SG
цэг	цэгээр	N;INS;SG
хөдлөл	хөдлөлийг	N;ACC;SG
сульдаа	сульдаанаас	N;ABL;SG
хэлэлцүүлэг	хэлэлцүүлгээ	N;VOC;SG
нөхөрлөл	нөхөрлөлөөр	N;INS;SG
хуудас	хуудсыг	N;ACC;SG
үзүүлбэр	үзүүлбэрээс	N;ABL;SG
шүвтэр	шүвтрээс	N;ABL;SG
сонирхогчийн	сонирхогчийн	N;GEN;SG
эрмэлзэл	эрмэлзлээс	N;ABL;SG
илтгэгч	илтгэгчийг	N;ACC;SG
бижрүү	бижрүүгээ	N;VOC;SG
биелэл	биеллээс	N;ABL;SG
зарц	зарцын	N;GEN;SG
давс	давсаа	N;VOC;SG
зохицуулалт	зохицуулалтыг	N;ACC;SG
санал	саналаа	N;VOC;SG
материализм	материализмаа	N;VOC;SG
туслагч	туслагчаа	N;VOC;SG
уртраг	уртрагаа	N;VOC;SG
хоосрох	хоосорсон	V;IND;PST
адар	адрын	N;GEN;SG
эвлэрүүлэгч	эвлэрүүлэгчийг	N;ACC;SG
дэлгүүр	дэлгүүрээс	N;ABL;SG
судар	судраа	N;VOC;SG
өгөөжтэй	өгөөжийн	N;GEN;SG
аймаг	аймгаар	N;INS;SG
осол	ослоо	N;VOC;SG
хүнд	хүндээ	N;VOC;SG
зөвлөгөө	зөвлөгөөний	N;GEN;SG
хойг	хойгоос	N;ABL;SG
ганхалт	ганхалтаар	N;INS;SG
оюутан	оюутныг	N;ACC;SG
хөдөлмөрчин	хөдөлмөрчнөөр	N;INS;SG
тах	тахнаас	N;ABL;SG
дагагч	дагагчийн	N;GEN;SG
залилан	залилангийн	N;GEN;SG
савлуур	савлуураас	N;ABL;SG
сонгино	сонгиноо	N;VOC;SG
хөх	хөхөө	N;VOC;SG
ховс	ховсоо	N;VOC;SG
мужаан	мужаанаар	N;INS;SG
мэргэжил	мэргэжлээ	N;VOC;SG
гөрөө	гөрөөг	N;ACC;SG
уран	ураны	N;GEN;SG
үерхэл	үерхлийг	N;ACC;SG
ноёрхол	ноёрхлоо	N;VOC;SG
нөхөөс	нөхөөсний	N;GEN;SG
бичээс	бичээсээр	N;INS;SG
таатай	таагаа	N;VOC;SG
хаяг	хаягийг	N;ACC;SG
тавцан	тавцангийн	N;GEN;SG
бижрүү	бижрүүгээр	N;INS;SG
найр	найрыг	N;ACC;SG
сэрвээ	сэрвээг	N;ACC;SG
нууц	нууцаас	N;ABL;SG
үерхэл	үерхлээр	N;INS;SG
бааз	баазаа	N;VOC;SG
хоолой	хоолойгоо	N;VOC;SG
дэлгүүр	дэлгүүрийн	N;GEN;SG
радиатор	радиаторыг	N;ACC;SG
үйлчлэл	үйлчлэлийн	N;GEN;SG
санаачлагч	санаачлагчийг	N;ACC;SG
аялагч	аялагчийг	N;ACC;SG
зохицуулагч	зохицуулагчаа	N;VOC;SG
зугаатай	зугаагаа	N;VOC;SG
нүүдэл	нүүдлээ	N;VOC;SG
дэгээ	дэгээнээс	N;ABL;SG
өчигдөр	өчигдрөөс	N;ABL;SG
бүтээлэг	бүтээлгээр	N;INS;SG
галзуурал	галзуурлаа	N;VOC;SG
дов	довоос	N;ABL;SG
ачлал	ачлалаас	N;ABL;SG
санамж	санамжийг	N;ACC;SG
бөмбөр	бөмбөрөөс	N;ABL;SG
дүнз	дүнзний	N;GEN;SG
манан	манангаа	N;VOC;SG
хавч	хавчны	N;GEN;SG
бэлтгэл	бэлтгэлийг	N;ACC;SG
ялагч	ялагчаар	N;INS;SG
нохой	нохойн	N;GEN;SG
хаалгач	хаалгачийн	N;GEN;SG
төрөх	төрчих	V;IMP;SG+PL;2
эмээл	эмээлийн	N;GEN;SG
наадам	наадмаас	N;ABL;SG
кофейн	кофейноор	N;INS;SG
шалгалт	шалгалтаас	N;ABL;SG
өв	өвөөр	N;INS;SG
чидун	чидуны	N;GEN;SG
гуа	гуаг	N;ACC;SG
баривчилгаа	баривчилгааг	N;ACC;SG
үзэгдэл	үзэгдлээр	N;INS;SG
гүтгэлэг	гүтгэлгийн	N;GEN;SG
илбэ	илбийн	N;GEN;SG
шургуулга	шургуулгаа	N;VOC;SG
төлөг	төлгөөр	N;INS;SG
урлаг	урлагийн	N;GEN;SG
устал	усталыг	N;ACC;SG
оролцоо	оролцоогоо	N;VOC;SG
тохуурхал	тохуурхлаа	N;VOC;SG
төлөгч	төлөгчийг	N;ACC;SG
мэдээ	мэдээнээс	N;ABL;SG
найруулга	найруулгын	N;GEN;SG
үгүйсгэл	үгүйсгэлээс	N;ABL;SG
судалгаа	судалгааг	N;ACC;SG
бичилт	бичилтээр	N;INS;SG
үндэслэл	үндэслэлээ	N;VOC;SG
оновчтой	оновчийг	N;ACC;SG
биежилт	биежилтээр	N;INS;SG
найр	найраар	N;INS;SG
хачирхалтай	хачирхлаар	N;INS;SG
скаут	скаутыг	N;ACC;SG
хүлээс	хүлээсээс	N;ABL;SG
ая	аяа	N;VOC;SG
шүүлт	шүүлтийн	N;GEN;SG
багш	багшийн	N;GEN;SG
шүршигч	шүршигчээс	N;ABL;SG
магтаал	магтаалаас	N;ABL;SG
зүлэг	зүлгээс	N;ABL;SG
хөхөвч	хөхөвчөөс	N;ABL;SG
ятгалга	ятгалгаа	N;VOC;SG
бахархал	бахархлаар	N;INS;SG
скаут	скаутаас	N;ABL;SG
хадгалалт	хадгалалтыг	N;ACC;SG
шингэлт	шингэлтийг	N;ACC;SG
зээлдүүлэгч	зээлдүүлэгчээ	N;VOC;SG
завхрал	завхралыг	N;ACC;SG
унжлага	унжлагаас	N;ABL;SG
хамелеон	хамелеоныг	N;ACC;SG
даяан	даяаны	N;GEN;SG
засвар	засварыг	N;ACC;SG
бөндгөр	бөндгөрийн	N;GEN;SG
видео	видеогоо	N;VOC;SG
мах	махаа	N;VOC;SG
наймаачин	наймаачны	N;GEN;SG
даяарших	авхуулав	V;PRF;IND;PRS
далай	далайг	N;ACC;SG
курс	курсийн	N;GEN;SG
услагч	услагчаар	N;INS;SG
зааг	заагийн	N;GEN;SG
зөвлөгч	зөвлөгчийн	N;GEN;SG
давталт	давталтаас	N;ABL;SG
зөвлөл	зөвлөлөөс	N;ABL;SG
шүхэр	шүхрийг	N;ACC;SG
төр	төрөө	N;VOC;SG
гавал	гавлаас	N;ABL;SG
хүн	хүнээр	N;INS;SG
баривчилгаа	баривчилгаагаар	N;INS;SG
хэллэг	хэллэгээ	N;VOC;SG
илээч	илээчээ	N;VOC;SG
зөвлөгөөн	зөвлөгөөнөөр	N;INS;SG
эвтэй	эвээс	N;ABL;SG
зурах	зурав	V;PRF;IND;PRS
зулай	зулайгаар	N;INS;SG
тэргүүлэгч	тэргүүлэгчээ	N;VOC;SG
үе	үеэр	N;INS;SG
шүлс	шүлсээ	N;VOC;SG
мөргөлдөөн	мөргөлдөөнөө	N;VOC;SG
сургамж	сургамжийг	N;ACC;SG
алт	алтаар	N;INS;SG
судал	судлын	N;GEN;SG
түрийвч	түрийвчийг	N;ACC;SG
сондгойрох	сондгойрсон	V;IND;PST
өдөр	өдрөөс	N;ABL;SG
онгоц	онгоцоор	N;INS;SG
огторгуй	огторгуйн	N;GEN;SG
геологи	геологиор	N;INS;SG
дээвэр	дээврийг	N;ACC;SG
зулгаах	зулгаачих	V;IMP;SG+PL;2
аялагч	аялагчаар	N;INS;SG
бамбар	бамбарын	N;GEN;SG
амттан	амттаны	N;GEN;SG
банк	банкаар	N;INS;SG
бут	бутны	N;GEN;SG
тасрал	тасралын	N;GEN;SG
жад	жаднаас	N;ABL;SG
угж	угжаа	N;VOC;SG
үлдэгдэл	үлдэгдлийн	N;GEN;SG
шавар	шавраас	N;ABL;SG
тэрслэгч	тэрслэгчийн	N;GEN;SG
түнш	түншээр	N;INS;SG
хүрээ	хүрээний	N;GEN;SG
хөрөөдөх	хөрөөдчих	V;IMP;SG+PL;2
хэц	хэцээс	N;ABL;SG
хорхой	хорхойн	N;GEN;SG
өтгөн	өтгөнөө	N;VOC;SG
өөрчлөлт	өөрчлөлтийн	N;GEN;SG
эмэгтэйчүүд	харьтаар	N;INS;SG
хамар	хамрыг	N;ACC;SG
арми	армийг	N;ACC;SG
онол	онолоос	N;ABL;SG
зөвшөөрөл	зөвшөөрлөөс	N;ABL;SG
тавилга	тавилгаар	N;INS;SG
уулзалт	уулзалтаас	N;ABL;SG
дэвтэр	дэвтрээ	N;VOC;SG
зурлага	зурлагаас	N;ABL;SG
ялагч	ялагчаа	N;VOC;SG
өгзөг	өгзгөөр	N;INS;SG
ухрах	ухрав	V;PRF;IND;PRS
дэвсгэр	дэвсгэрээр	N;INS;SG
намаг	намгийг	N;ACC;SG
ил	илээ	N;VOC;SG
тохироо	тохироогоо	N;VOC;SG
энгэр	энгэрийг	N;ACC;SG
гагнуурчин	гагнуурчнаас	N;ABL;SG
тэнгис	тэнгисээ	N;VOC;SG
бэлгэдэл	бэлгэдлээс	N;ABL;SG
луйвар	луйвраас	N;ABL;SG
үзүүлэлт	үзүүлэлтээ	N;VOC;SG
үгүйсгэл	үгүйсгэлийг	N;ACC;SG
мяндас	мяндсаа	N;VOC;SG
өт	өтөөр	N;INS;SG
фронт	фронтоор	N;INS;SG
шүүс	шүүсээр	N;INS;SG
наалдац	наалдцаа	N;VOC;SG
ширээс	ширээсээс	N;ABL;SG
ертөнц	ертөнцийг	N;ACC;SG
ордон	ордноо	N;VOC;SG
тохижуулалт	тохижуулалтыг	N;ACC;SG
үүл	үүлээс	N;ABL;SG
бөөм	бөөмийг	N;ACC;SG
элэгдэл	элэгдлийн	N;GEN;SG
дээвэр	дээврээр	N;INS;SG
зүүд	зүүдний	N;GEN;SG
орчуулга	орчуулгаар	N;INS;SG
дун	дунг	N;ACC;SG
завхайрал	завхайрлын	N;GEN;SG
баримжаа	баримжаагаар	N;INS;SG
ядаргаа	ядаргаагаар	N;INS;SG
суудал	суудлаар	N;INS;SG
галлалт	галлалтаас	N;ABL;SG
түвшин	түвшнээ	N;VOC;SG
тасаг	тасгаа	N;VOC;SG
удирдлага	удирдлагын	N;GEN;SG
дүүргэлт	дүүргэлтийг	N;ACC;SG
индекс	индексээс	N;ABL;SG
болзоо	болзооны	N;GEN;SG
үлдэгдэл	үлдэгдлээ	N;VOC;SG
цэрэг	цэргээ	N;VOC;SG
цахлай	цахлайнаас	N;ABL;SG
могой	могойг	N;ACC;SG
пиво	пивоор	N;INS;SG
хорсол	хорслоос	N;ABL;SG
худаг	худгаас	N;ABL;SG
нөхөр	нөхрөөс	N;ABL;SG
эвдрэл	эвдрэлийн	N;GEN;SG
элэг	элгийг	N;ACC;SG
эцэс	эцсээ	N;VOC;SG
наймаа	наймаанаас	N;ABL;SG
нүх	нүхээ	N;VOC;SG
эргүү	эргүүг	N;ACC;SG
хирс	хирсээс	N;ABL;SG
сүлбэлдээн	сүлбэлдээнээр	N;INS;SG
худалдагч	худалдагчийг	N;ACC;SG
нийгэмлэг	нийгэмлэгийг	N;ACC;SG
амь	аминаас	N;ABL;SG
даралт	даралтаас	N;ABL;SG
хардалт	хардалтын	N;GEN;SG
харвалт	харвалтаар	N;INS;SG
эргэлт	эргэлтээс	N;ABL;SG
төгсөгч	төгсөгчийг	N;ACC;SG
шунал	шуналыг	N;ACC;SG
дуулга	дуулгаар	N;INS;SG
тэмтрэх	тэмтэрчих	V;IMP;SG+PL;2
зээрэнцэг	зээрэнцгээс	N;ABL;SG
хүндрэл	хүндрэлийн	N;GEN;SG
дэнлүү	дэнлүүгээ	N;VOC;SG
луужин	луужингаас	N;ABL;SG
дүрслэл	дүрслэлээр	N;INS;SG
тусламж	тусламжаа	N;VOC;SG
сүр	сүрийг	N;ACC;SG
сэргээш	сэргээшээ	N;VOC;SG
таслал	таслалаа	N;VOC;SG
бүрэлбаа	бүрэлбаанаас	N;ABL;SG
хориглолт	хориглолтыг	N;ACC;SG
цорго	цоргоны	N;GEN;SG
дэвтэр	дэвтрээр	N;INS;SG
хайлт	хайлтыг	N;ACC;SG
санхүүч	санхүүчийг	N;ACC;SG
шувуу	шувуугаа	N;VOC;SG
сургаал	сургаалаас	N;ABL;SG
экологи	экологио	N;VOC;SG
философи	философиос	N;ABL;SG
талбар	талбараар	N;INS;SG
баатар	баатрыг	N;ACC;SG
үзүүлэлт	үзүүлэлтийг	N;ACC;SG
үйлчлүүлэгч	үйлчлүүлэгчээр	N;INS;SG
унжлага	унжлагаар	N;INS;SG
ёсолгоо	ёсолгоогоо	N;VOC;SG
хэрэгжилт	хэрэгжилтийг	N;ACC;SG
гараа	гараанаас	N;ABL;SG
барьцалдаа	барьцалдаагаар	N;INS;SG
сорилт	сорилтыг	N;ACC;SG
хугарал	хугарлаа	N;VOC;SG
хатуурал	хатуурлыг	N;ACC;SG
эсрэгцэл	эсрэгцлээ	N;VOC;SG
сэжигтэн	сэжигтнийг	N;ACC;SG
хувь	хувийн	N;GEN;SG
ажиллагаа	ажиллагааг	N;ACC;SG
нөөц	нөөцөөс	N;ABL;SG
урамшуулал	урамшууллаар	N;INS;SG
цацаг	цацгаа	N;VOC;SG
бүлүүр	бүлүүрээр	N;INS;SG
бохь	бохиноос	N;ABL;SG
танил	танилаар	N;INS;SG
зохиогч	зохиогчоос	N;ABL;SG
өд	өднөөс	N;ABL;SG
эцэг	эцгээс	N;ABL;SG
харьцуулал	харьцууллыг	N;ACC;SG
өсгөлт	өсгөлтөөс	N;ABL;SG
урилга	урилгаа	N;VOC;SG
өмсгөл	өмсгөлөөр	N;INS;SG
нэхэмжлэгч	нэхэмжлэгчийн	N;GEN;SG
нууцлал	нууцлалын	N;GEN;SG
дасгал	дасгалыг	N;ACC;SG
тахал	тахлын	N;GEN;SG
үүсгэл	үүсгэлээр	N;INS;SG
хямдрал	хямдралаа	N;VOC;SG
мэтгэлцээн	мэтгэлцээнээ	N;VOC;SG
арал	арлын	N;GEN;SG
гялбаа	гялбааг	N;ACC;SG
биелэл	биеллийг	N;ACC;SG
сейф	сейфийг	N;ACC;SG
гомдол	гомдлын	N;GEN;SG
масштаб	масштабын	N;GEN;SG
цэцэг	цэцгээ	N;VOC;SG
ширээ	ширээгээр	N;INS;SG
дөнжөө	дөнжөөр	N;INS;SG
яам	яамаар	N;INS;SG
зохиол	зохиолын	N;GEN;SG
хэллэг	хэллэгийг	N;ACC;SG
ноогдол	ноогдлоор	N;INS;SG
тулгуур	тулгуураа	N;VOC;SG
гулсуур	гулсуурыг	N;ACC;SG
шивнээ	шивнээнээс	N;ABL;SG
мэндчилгээ	мэндчилгээгээр	N;INS;SG
хөөс	хөөсөөр	N;INS;SG
хөг	хөгийн	N;GEN;SG
сорох	соёлжооч	V;IMP;PL;2;PRS
тос	тосоор	N;INS;SG
солонго	солонгыг	N;ACC;SG
худаг	худгийг	N;ACC;SG
гэдэс	гэдсийг	N;ACC;SG
эгзэгтэй	эгзгийн	N;GEN;SG
банк	банкны	N;GEN;SG
хариуцагч	хариуцагчаар	N;INS;SG
хорсол	хорслын	N;GEN;SG
сорилго	сорилгоо	N;VOC;SG
дадлага	дадлагаас	N;ABL;SG
боломж	боломжийг	N;ACC;SG
хүүхэд	хүүхдээр	N;INS;SG
хувьсагч	хувьсагчийг	N;ACC;SG
тогтолцоо	тогтолцоогоо	N;VOC;SG
гуа	гуаны	N;GEN;SG
огторгуй	огторгуйг	N;ACC;SG
худаг	худгаа	N;VOC;SG
ялгаа	ялгааг	N;ACC;SG
баяр	баярын	N;GEN;SG
орлого	орлогыг	N;ACC;SG
хурандаа	хурандаагийн	N;GEN;SG
дамнуурга	дамнуургаар	N;INS;SG
костюм	костюмаас	N;ABL;SG
үс	үсээр	N;INS;SG
баримтлал	баримтлалаар	N;INS;SG
уншлага	уншлагаас	N;ABL;SG
нэхий	нэхийгээс	N;ABL;SG
хүндэтгэл	хүндэтгэлээ	N;VOC;SG
үүрэг	үүргээ	N;VOC;SG
хоцрогч	хоцрогчийн	N;GEN;SG
асар	асраас	N;ABL;SG
тосгон	тосгоноо	N;VOC;SG
оптимизм	оптимизмоо	N;VOC;SG
сүсэгтэн	сүсэгтнээс	N;ABL;SG
эвсэл	эвслээс	N;ABL;SG
салбар	салбарын	N;GEN;SG
төөрөгдөл	төөрөгдлийн	N;GEN;SG
тэмцээн	тэмцээнээ	N;VOC;SG
лазер	лазераа	N;VOC;SG
хоцрогдол	хоцрогдлыг	N;ACC;SG
түгжрэл	түгжрэлийг	N;ACC;SG
сүйтгэгч	сүйтгэгчээр	N;INS;SG
өнгө	өнгөөр	N;INS;SG
коммунизм	коммунизмын	N;GEN;SG
сүүдэр	сүүдрээс	N;ABL;SG
туяа	туяанаас	N;ABL;SG
гахай	гахайгаар	N;INS;SG
бассейн	бассейнаас	N;ABL;SG
салтаа	салтаагаар	N;INS;SG
тавцан	тавцангаа	N;VOC;SG
авс	авсыг	N;ACC;SG
савхдах	савхадчих	V;IMP;SG+PL;2
шүлсэвч	шүлсэвчээс	N;ABL;SG
галлалт	галлалтаа	N;VOC;SG
туслагч	туслагчийг	N;ACC;SG
хошуучлагч	хошуучлагчаар	N;INS;SG
хорио	хорионоос	N;ABL;SG
үрэл	үрлээ	N;VOC;SG
маркетинг	маркетингаар	N;INS;SG
бүйлс	бүйлсээ	N;VOC;SG
төлөвлөгөө	төлөвлөгөөний	N;GEN;SG
уртраг	уртрагийн	N;GEN;SG
хондлой	хондлойгоо	N;VOC;SG
эвсэл	эвслээ	N;VOC;SG
зураглал	зураглалаар	N;INS;SG
цөм	цөмөөр	N;INS;SG
ил	илээр	N;INS;SG
тариур	тариураа	N;VOC;SG
харвин	харвинг	N;ACC;SG
асуулга	асуулгыг	N;ACC;SG
нотолгоо	нотолгоогоо	N;VOC;SG
хөхөвч	хөхөвчөөр	N;INS;SG
хулуу	хулууны	N;GEN;SG
хөгжимчин	хөгжимчний	N;GEN;SG
сурагч	сурагчаа	N;VOC;SG
сувд	сувдаас	N;ABL;SG
хуурай	хуурайн	N;GEN;SG
өргөрөг	өргөргөө	N;VOC;SG
гарц	гарцыг	N;ACC;SG
ариутгал	ариутгалаар	N;INS;SG
материализм	материализмын	N;GEN;SG
гэргий	гэргийн	N;GEN;SG
эвэр	эврийн	N;GEN;SG
халамж	халамжаас	N;ABL;SG
гургуул	гургуулаас	N;ABL;SG
буудлага	буудлагаас	N;ABL;SG
задрал	задралаа	N;VOC;SG
махлаг	махлагаар	N;INS;SG
ярилцлага	ярилцлагаа	N;VOC;SG
сүү	сүүний	N;GEN;SG
хэрүүл	хэрүүлээс	N;ABL;SG
тонуул	тонуулыг	N;ACC;SG
шуурга	шуурганы	N;GEN;SG
жим	жимээ	N;VOC;SG
үүргэвч	үүргэвчнээс	N;ABL;SG
гэрэлтүүлэг	гэрэлтүүлгээ	N;VOC;SG
зам	замын	N;GEN;SG
оршил	оршлыг	N;ACC;SG
амьдрал	амьдралаар	N;INS;SG
лаа	лаагаа	N;VOC;SG
цемент	цементийн	N;GEN;SG
исэлт	исэлтийн	N;GEN;SG
шалгагч	шалгагчийн	N;GEN;SG
хөшүүрэг	хөшүүргээ	N;VOC;SG
цардуул	цардуулаас	N;ABL;SG
тарилга	тарилгаар	N;INS;SG
гоёл	гоёлоос	N;ABL;SG
хавчлага	хавчлагаас	N;ABL;SG
чулуу	чулуугаа	N;VOC;SG
илд	илдний	N;GEN;SG
царцаа	царцааны	N;GEN;SG
нягтшил	нягтшилаар	N;INS;SG
таатай	таагаар	N;INS;SG
түгшүүр	түгшүүрээ	N;VOC;SG
сургалт	сургалтаа	N;VOC;SG
зочин	зочны	N;GEN;SG
жимс	жимсийг	N;ACC;SG
цалин	цалинг	N;ACC;SG
байнгын	байнгаа	N;VOC;SG
татвар	татварыг	N;ACC;SG
нийцэл	нийцлээр	N;INS;SG
адилтгал	адилтгалыг	N;ACC;SG
боломж	боломжоос	N;ABL;SG
уураг	уургаас	N;ABL;SG
дайралт	дайралтаас	N;ABL;SG
зугаа	зугааны	N;GEN;SG
дасгал	дасгалаа	N;VOC;SG
доромжлол	доромжлолоор	N;INS;SG
судар	судрын	N;GEN;SG
ван	ванг	N;ACC;SG
гөлөг	гөлөгнөөс	N;ABL;SG
шийдвэрлэгч	шийдвэрлэгчээ	N;VOC;SG
элемент	элементийн	N;GEN;SG
газар	газрын	N;GEN;SG
доргио	доргионоос	N;ABL;SG
онош	оношноос	N;ABL;SG
наалт	наалтыг	N;ACC;SG
ахлагч	ахлагчийг	N;ACC;SG
зүтгэл	зүтгэлийн	N;GEN;SG
дугтуй	дугтуйгаар	N;INS;SG
эвлэрэл	эвлэрлээ	N;VOC;SG
талийгаач	талийгаачаар	N;INS;SG
өмхий	өмхийээс	N;ABL;SG
төгсгөл	төгсгөлөөс	N;ABL;SG
углааш	углаашаа	N;VOC;SG
арифметик	арифметикийн	N;GEN;SG
ирц	ирцээр	N;INS;SG
урлаг	урлагийг	N;ACC;SG
фонт	фонтоос	N;ABL;SG
илтгэгч	илтгэгчээс	N;ABL;SG
ярилцлага	ярилцлагыг	N;ACC;SG
ур	урын	N;GEN;SG
мэрийлт	мэрийлтээр	N;INS;SG
давхарга	давхаргаа	N;VOC;SG
касс	кассаа	N;VOC;SG
түнш	түншийн	N;GEN;SG
сурталчилгааны	сурталчилгаанаас	N;ABL;SG
гүн	гүнгээс	N;ABL;SG
мэдээлэх	мэдээлжээ	V;IND;PST
робот	роботоор	N;INS;SG
зулай	зулайнаас	N;ABL;SG
цагдаа	цагдаагийн	N;GEN;SG
квадрат	квадратаар	N;INS;SG
зэрэг	зэргээр	N;INS;SG
мөөг	мөөгийг	N;ACC;SG
сэлгээ	сэлгээгээр	N;INS;SG
булш	булшнаас	N;ABL;SG
даруул	даруулыг	N;ACC;SG
хаялт	хаялтыг	N;ACC;SG
байнгын	байнгаар	N;INS;SG
лоозон	лоозонг	N;ACC;SG
луус	луусаар	N;INS;SG
өндөг	өндгөө	N;VOC;SG
луу	лууг	N;ACC;SG
нүд	нүдний	N;GEN;SG
байдал	байдлаас	N;ABL;SG
ноён	ноёноор	N;INS;SG
шаазан	шаазангийн	N;GEN;SG
мөрөөдөл	мөрөөдлөөс	N;ABL;SG
хэвлэлт	хэвлэлтээс	N;ABL;SG
бараа	бараагаар	N;INS;SG
танхим	танхимын	N;GEN;SG
дарангуйлал	дарангуйллаар	N;INS;SG
исэг	исгийг	N;ACC;SG
тайтгарал	тайтгарлыг	N;ACC;SG
шоглоом	шоглоомоос	N;ABL;SG
хүү	хүүгээр	N;INS;SG
тохой	тохойгоо	N;VOC;SG
тэмдэглэл	тэмдэглэлээс	N;ABL;SG
хугацаа	хугацаагаа	N;VOC;SG
удамшил	удамшлаа	N;VOC;SG
манлайлагч	манлайлагчаа	N;VOC;SG
тэмдэглэл	тэмдэглэлийг	N;ACC;SG
булингартай	булингарыг	N;ACC;SG
үгүйсгэл	үгүйсгэлээр	N;INS;SG
хувьсгал	хувьсгалаа	N;VOC;SG
цацаг	цацгаас	N;ABL;SG
гаргалт	гаргалтаа	N;VOC;SG
нахиа	нахианаас	N;ABL;SG
дэл	дэлийн	N;GEN;SG
торгууль	торгуулиас	N;ABL;SG
саа	саанаас	N;ABL;SG
горим	горимоо	N;VOC;SG
жараахай	жараахайн	N;GEN;SG
оргил	оргилоос	N;ABL;SG
идеализм	идеализмаас	N;ABL;SG
тэсрэлт	тэсрэлтээ	N;VOC;SG
хурд	хурдны	N;GEN;SG
хонх	хонхоор	N;INS;SG
цохилт	цохилтоос	N;ABL;SG
дахилт	дахилтаа	N;VOC;SG
тогооч	тогоочийг	N;ACC;SG
чоно	чононоос	N;ABL;SG
сэтгэгдэл	сэтгэгдлийн	N;GEN;SG
элемент	элементээс	N;ABL;SG
залилан	залиланг	N;ACC;SG
гүйлт	гүйлтийг	N;ACC;SG
түлээчин	түлээчнийг	N;ACC;SG
тэмцэл	тэмцлийг	N;ACC;SG
диаграмм	диаграммын	N;GEN;SG
цэнгүүн	цэнгүүнээр	N;INS;SG
радиус	радиусаас	N;ABL;SG
үртэс	үртэсний	N;GEN;SG
ухрах	ухарсан	V;IND;PST
дэмжигч	дэмжигчээ	N;VOC;SG
тохуурхал	тохуурхлаар	N;INS;SG
үргэлжлэл	үргэлжлэлээ	N;VOC;SG
эзэн	эзнээ	N;VOC;SG
өчиг	өчгөөс	N;ABL;SG
хаан	хаанаа	N;VOC;SG
хигээс	хигээсээр	N;INS;SG
солир	солироор	N;INS;SG
организм	организмоор	N;INS;SG
жишээ	жишээнээс	N;ABL;SG
гялбаа	гялбааны	N;GEN;SG
орлогч	орлогчоор	N;INS;SG
үртэс	үртэснээс	N;ABL;SG
ажилчин	ажилчнаа	N;VOC;SG
шийд	шийдээ	N;VOC;SG
цорго	цоргоор	N;INS;SG
буудал	буудлаас	N;ABL;SG
зарлага	зарлагын	N;GEN;SG
ботаник	ботаникийг	N;ACC;SG
сонгууль	сонгуулийг	N;ACC;SG
хүчтэй	хүчийг	N;ACC;SG
жоотуу	жоотуугаа	N;VOC;SG
бартаа	бартааг	N;ACC;SG
бульдозер	бульдозероор	N;INS;SG
цирк	циркээ	N;VOC;SG
биелэл	биеллийн	N;GEN;SG
хаалт	хаалтаа	N;VOC;SG
цус	цусны	N;GEN;SG
протокол	протоколоор	N;INS;SG
дэлхий	дэлхийгээ	N;VOC;SG
нөхөрлөл	нөхөрлөлөөс	N;ABL;SG
гацуур	гацуураа	N;VOC;SG
өр	өрөөр	N;INS;SG
сонсох	товойв	V;PRF;IND;PRS
голд	голоор	N;INS;SG
хийсвэрлэл	хийсвэрлэлээр	N;INS;SG
бөгс	бөгсөөр	N;INS;SG
дэлгэрэлт	дэлгэрэлтээр	N;INS;SG
дуншилт	дуншилтыг	N;ACC;SG
тэмдэглэл	тэмдэглэлээ	N;VOC;SG
үйс	үйсээ	N;VOC;SG
хурдатгал	хурдатгалаа	N;VOC;SG
сахал	сахлыг	N;ACC;SG
хүчил	хүчлээс	N;ABL;SG
автобус	автобусыг	N;ACC;SG
мөрдөгч	мөрдөгчөөр	N;INS;SG
пост	постын	N;GEN;SG
мансуурал	мансуурлыг	N;ACC;SG
хүчирхийлэл	хүчирхийллээр	N;INS;SG
удам	удмын	N;GEN;SG
шураг	шургаар	N;INS;SG
ханиад	ханиадны	N;GEN;SG
соёо	соёоны	N;GEN;SG
экологи	экологийг	N;ACC;SG
шүхэр	шүхрээр	N;INS;SG
шулам	шулмаас	N;ABL;SG
дүрвэгч	дүрвэгчээр	N;INS;SG
кафе	кафены	N;GEN;SG
хөдөлмөрчин	хөдөлмөрчнөө	N;VOC;SG
текст	текстийн	N;GEN;SG
өгөөш	өгөөшний	N;GEN;SG
түгжээ	түгжээгээ	N;VOC;SG
тахал	тахлаас	N;ABL;SG
урлал	урлалын	N;GEN;SG
ухагдахуун	ухагдахуунаас	N;ABL;SG
уялдаа	уялдаанаас	N;ABL;SG
гүжирдлэг	гүжирдлэгийн	N;GEN;SG
отряд	отрядын	N;GEN;SG
шумуул	шумуулын	N;GEN;SG
амуу	амууны	N;GEN;SG
хуяг	хуягийн	N;GEN;SG
хигээс	хигээсийг	N;ACC;SG
шившиг	шившгийг	N;ACC;SG
сургууль	сургуулийг	N;ACC;SG
хичээл	хичээлээс	N;ABL;SG
тахиа	тахиагаар	N;INS;SG
бамбай	бамбайн	N;GEN;SG
шууданч	шууданчийн	N;GEN;SG
командлагч	командлагчийн	N;GEN;SG
төлбөр	төлбөрөөс	N;ABL;SG
сэдэв	сэдвийн	N;GEN;SG
сонирхогч	сонирхогчоос	N;ABL;SG
сархад	сархдыг	N;ACC;SG
үнэ	үнийг	N;ACC;SG
оёдолчин	оёдолчноор	N;INS;SG
будаг	будгаар	N;INS;SG
үржвэр	үржвэрээр	N;INS;SG
ангаахай	ангаахайн	N;GEN;SG
байлдаан	байлдааны	N;GEN;SG
нүх	нүхээс	N;ABL;SG
атга	атгаа	N;VOC;SG
бахархал	бахархлын	N;GEN;SG
тогтворжилт	тогтворжилтоор	N;INS;SG
мэргэ	мэргэний	N;GEN;SG
лоозон	лоозонгоор	N;INS;SG
гэргий	гэргийгээр	N;INS;SG
дам	дамын	N;GEN;SG
программ	программын	N;GEN;SG
реализм	реализмыг	N;ACC;SG
нөхвөр	нөхвөрийн	N;GEN;SG
ахиц	ахицаа	N;VOC;SG
тусгал	тусгалын	N;GEN;SG
сондгойрох	сондгойрвол	V.CVB;LGSPEC03
гарал	гарлыг	N;ACC;SG
хандлага	хандлагыг	N;ACC;SG
хорвоо	хорвоогоор	N;INS;SG
судал	судлаа	N;VOC;SG
зоодой	зоодойгоос	N;ABL;SG
алдагдал	алдагдлаар	N;INS;SG
хэллэг	хэллэгийн	N;GEN;SG
бүсгүй	бүсгүйгээр	N;INS;SG
ухаарал	ухаарлаас	N;ABL;SG
хэмнэлт	хэмнэлтээс	N;ABL;SG
бөөр	бөөрөө	N;VOC;SG
хэлбэр	хэлбэрээ	N;VOC;SG
чагнаал	чагнаалаас	N;ABL;SG
урц	урцнаас	N;ABL;SG
бүртгэл	бүртгэлийг	N;ACC;SG
хөвгүүн	хөвгүүнийг	N;ACC;SG
бэлгэдэл	бэлгэдлийг	N;ACC;SG
хуримтлал	хуримтлалаар	N;INS;SG
хүдэр	хүдрээ	N;VOC;SG
тавцан	тавцангаас	N;ABL;SG
илтгэл	илтгэлээр	N;INS;SG
шүүдэр	шүүдрийн	N;GEN;SG
тавцан	тавцангаар	N;INS;SG
өгзөг	өгзөгний	N;GEN;SG
глюкоз	глюкозоос	N;ABL;SG
ботаник	ботаникийн	N;GEN;SG
саун	сауны	N;GEN;SG
зөгий	зөгийг	N;ACC;SG
хөргөгч	хөргөгчөө	N;VOC;SG
тогтоол	тогтоолоос	N;ABL;SG
дамжаа	дамжаанаас	N;ABL;SG
зуслан	зуслангаа	N;VOC;SG
дэлбэрэлт	дэлбэрэлтийг	N;ACC;SG
тагнуул	тагнуулыг	N;ACC;SG
гарз	гарзны	N;GEN;SG
шийд	шийдийн	N;GEN;SG
ашиг	ашгийн	N;GEN;SG
найрууламж	найрууламжийг	N;ACC;SG
сэдэв	сэдвээр	N;INS;SG
жишээ	жишээг	N;ACC;SG
костюм	костюмаар	N;INS;SG
обой	обойг	N;ACC;SG
үүрэг	үүргээс	N;ABL;SG
долгио	долгионы	N;GEN;SG
шилжилт	шилжилтээ	N;VOC;SG
жигтэй	жигээс	N;ABL;SG
уйтгар	уйтгараас	N;ABL;SG
хүслэн	хүслэнгээ	N;VOC;SG
өмсгөл	өмсгөлөө	N;VOC;SG
эрхлэгч	эрхлэгчээр	N;INS;SG
хэрэгтэн	хэрэгтнээс	N;ABL;SG
тос	тосны	N;GEN;SG
ханш	ханшаар	N;INS;SG
хэмжээ	хэмжээгээр	N;INS;SG
гахай	гахайн	N;GEN;SG
төрөх	төрсөн	V;IND;PST
туурай	туурайг	N;ACC;SG
егөө	егөөгөө	N;VOC;SG
пиво	пивоны	N;GEN;SG
барьцаа	барьцааг	N;ACC;SG
эвсэл	эвслийн	N;GEN;SG
хүн	хүнээ	N;VOC;SG
жинлүүр	жинлүүрийн	N;GEN;SG
илтгэл	илтгэлээ	N;VOC;SG
биелэлт	биелэлтээр	N;INS;SG
салбар	салбараар	N;INS;SG
сонирхол	сонирхлыг	N;ACC;SG
өнгөлөх	өнгөлчих	V;IMP;SG+PL;2
маргаан	маргааныг	N;ACC;SG
амжилт	амжилтын	N;GEN;SG
зааг	заагийг	N;ACC;SG
ухуулга	ухуулгыг	N;ACC;SG
жолоо	жолооны	N;GEN;SG
үнсэлт	үнсэлтээр	N;INS;SG
тэмдэг	тэмдгээ	N;VOC;SG
эс	эсээс	N;ABL;SG
бай	байны	N;GEN;SG
кредит	кредитээ	N;VOC;SG
хүч	хүчээ	N;VOC;SG
түрэмгийлэл	түрэмгийллээ	N;VOC;SG
нидрүүлэг	нидрүүлгийг	N;ACC;SG
цавь	цавинаас	N;ABL;SG
түрэмгийлэл	түрэмгийллийг	N;ACC;SG
исэлт	исэлтээс	N;ABL;SG
хөдлөл	хөдлөлөө	N;VOC;SG
ноогдол	ноогдлоо	N;VOC;SG
үсчин	үсчнээ	N;VOC;SG
тогтвор	тогтворын	N;GEN;SG
цааз	цаазын	N;GEN;SG
мангас	мангасын	N;GEN;SG
янжуур	янжуураас	N;ABL;SG
гудамж	гудамжаар	N;INS;SG
улс	улсын	N;GEN;SG
хурал	хурлаа	N;VOC;SG
янхан	янхнаас	N;ABL;SG
хүү	хүүгээ	N;VOC;SG
шүлэгч	шүлэгчээ	N;VOC;SG
бааз	баазаас	N;ABL;SG
хэвлэл	хэвлэлээр	N;INS;SG
шүүлтүүр	шүүлтүүрээс	N;ABL;SG
тасалгаа	тасалгаагаар	N;INS;SG
нууц	нууцаа	N;VOC;SG
уурхай	уурхайг	N;ACC;SG
хавар	хавраа	N;VOC;SG
шаналгаа	шаналгаанаас	N;ABL;SG
уршиг	уршгаас	N;ABL;SG
тэмтрүүл	тэмтрүүлийг	N;ACC;SG
овоолох	орогноцгоо	V;IMP;PL;2;PRS
араншин	араншинг	N;ACC;SG
товойх	товойвол	V.CVB;LGSPEC03
ургамал	ургамлын	N;GEN;SG
шүүлт	шүүлтийг	N;ACC;SG
үйлдвэрлэгч	үйлдвэрлэгчээр	N;INS;SG
дараалал	дарааллаас	N;ABL;SG
уриа	уриагаа	N;VOC;SG
аялагч	аялагчийн	N;GEN;SG
манан	манангаас	N;ABL;SG
хөхөвч	хөхөвчийн	N;GEN;SG
багш	багшаа	N;VOC;SG
хангалт	хангалтаа	N;VOC;SG
барилга	барилгаас	N;ABL;SG
хавирга	хавиргаар	N;INS;SG
тогтолцоо	тогтолцоогоор	N;INS;SG
бахь	бахинаас	N;ABL;SG
адилсал	адилслаар	N;INS;SG
гуйлгачин	гуйлгачнаа	N;VOC;SG
протокол	протоколыг	N;ACC;SG
сондгойрох	сондгойрцгоо	V;IMP;PL;2;PRS
пост	постоор	N;INS;SG
цэцэглэлт	цэцэглэлтээр	N;INS;SG
хатуулга	хатуулгыг	N;ACC;SG
бодолт	бодолтоос	N;ABL;SG
зөвлөмж	зөвлөмжийн	N;GEN;SG
гоёл	гоёлоо	N;VOC;SG
ажиллагаа	ажиллагаагаар	N;INS;SG
хэмжээс	хэмжээсийг	N;ACC;SG
жатга	жатгаа	N;VOC;SG
дураараа	дурнаас	N;ABL;SG
устал	усталын	N;GEN;SG
амбаар	амбаараа	N;VOC;SG
харагдац	харагдцаа	N;VOC;SG
бааш	баашийг	N;ACC;SG
гэгээрэл	гэгээрлийн	N;GEN;SG
мансуурал	мансуурлаар	N;INS;SG
зөвлөл	зөвлөлөөр	N;INS;SG
бүйлс	бүйлсний	N;GEN;SG
шумбагч	шумбагчаар	N;INS;SG
эм	эмээр	N;INS;SG
сал	салыг	N;ACC;SG
философи	философийн	N;GEN;SG
үсэг	үсгээс	N;ABL;SG
боловсруулалт	боловсруулалтаас	N;ABL;SG
хуурай	хуурайг	N;ACC;SG
үнэ	үнээр	N;INS;SG
дарамт	дарамтаа	N;VOC;SG
жолоо	жолооноос	N;ABL;SG
гивлүүр	гивлүүрээс	N;ABL;SG
шүлт	шүлтээр	N;INS;SG
адилтгал	адилтгалаа	N;VOC;SG
шинжилгээ	шинжилгээг	N;ACC;SG
зулгаах	зулгаав	V;PRF;IND;PRS
өрсөлдөгч	өрсөлдөгчөөс	N;ABL;SG
бассейн	бассейны	N;GEN;SG
савхдах	савхадсан	V;IND;PST
цэцэг	цэцгийн	N;GEN;SG
хонго	хонгоноос	N;ABL;SG
хэрэг	хэргээр	N;INS;SG
эрх	эрхээс	N;ABL;SG
медаль	медалиас	N;ABL;SG
соронз	соронзоос	N;ABL;SG
жоотуу	жоотууг	N;ACC;SG
онош	оношоор	N;INS;SG
загас	загаснаас	N;ABL;SG
эргэлт	эргэлтийн	N;GEN;SG
цохиур	цохиурын	N;GEN;SG
бахархал	бахархлыг	N;ACC;SG
ханцуй	ханцуйг	N;ACC;SG
гахиур	гахиурыг	N;ACC;SG
хөрөг	хөргийг	N;ACC;SG
гинж	гинжний	N;GEN;SG
хавчаар	хавчаараа	N;VOC;SG
өтгөн	өтгөнөөр	N;INS;SG
заавар	заавраас	N;ABL;SG
гацуур	гацуурын	N;GEN;SG
шүгэл	шүглээс	N;ABL;SG
дарамт	дарамтаас	N;ABL;SG
овоолох	орогночих	V;IMP;SG+PL;2
пост	постыг	N;ACC;SG
батга	батгаар	N;INS;SG
зайрмаг	зайрмагийн	N;GEN;SG
найруулагч	найруулагчийг	N;ACC;SG
гацаа	гацааг	N;ACC;SG
өргөтгөл	өргөтгөлөө	N;VOC;SG
бэлгэдэл	бэлгэдлийн	N;GEN;SG
бааш	баашны	N;GEN;SG
тэмдэг	тэмдгийн	N;GEN;SG
дурсамж	дурсамжаа	N;VOC;SG
дүнз	дүнзээ	N;VOC;SG
савхдах	савхадвал	V.CVB;LGSPEC03
захидал	захидлаа	N;VOC;SG
даяарших	авхуулцгаа	V;IMP;PL;2;PRS
дэвсгэр	дэвсгэрийн	N;GEN;SG
протокол	протоколоо	N;VOC;SG
үер	үерээ	N;VOC;SG
сав	савнаас	N;ABL;SG
өмгөөлөгч	өмгөөлөгчийн	N;GEN;SG
мөрдөгч	мөрдөгчөөс	N;ABL;SG
тасаг	тасгийг	N;ACC;SG
саван	савангаар	N;INS;SG
боломж	боломжоор	N;INS;SG
донтон	донтны	N;GEN;SG
үйл	үйлийг	N;ACC;SG
хөрөөдөх	өвөрлөцгөө	V;IMP;PL;2;PRS
гадас	гадсаар	N;INS;SG
цус	цуснаас	N;ABL;SG
гүйцэтгэл	гүйцэтгэлийн	N;GEN;SG
төлөвлөгөө	төлөвлөгөөгөө	N;VOC;SG
цэцэглэлт	цэцэглэлтийн	N;GEN;SG
өр	өрөө	N;VOC;SG
тэвчээр	тэвчээрийн	N;GEN;SG
ритм	ритмийг	N;ACC;SG
үүл	үүлээ	N;VOC;SG
эрхшээл	эрхшээлийг	N;ACC;SG
хаалга	хаалгаа	N;VOC;SG
хөлслөгч	хөлслөгчөөс	N;ABL;SG
генерал	генералыг	N;ACC;SG
завь	завины	N;GEN;SG
тоншуул	тоншуулыг	N;ACC;SG
хожуул	хожуулаас	N;ABL;SG
санаа	санааны	N;GEN;SG
шүүс	шүүсээ	N;VOC;SG
таамаг	таамгаа	N;VOC;SG
ханиад	ханиадаар	N;INS;SG
мэрэгч	мэрэгчийг	N;ACC;SG
залуур	залуураар	N;INS;SG
гараг	гаргаа	N;VOC;SG
агаар	агаарын	N;GEN;SG
хадаас	хадаасаа	N;VOC;SG
бэрхшээл	бэрхшээлийн	N;GEN;SG
шүтээн	шүтээнийг	N;ACC;SG
цуглуулагч	цуглуулагчаа	N;VOC;SG
гэлэнмаа	гэлэнмаагийн	N;GEN;SG
сайжруулалт	сайжруулалтыг	N;ACC;SG
синдром	синдромоор	N;INS;SG
түгжрэл	түгжрэлээс	N;ABL;SG
хурдасгагч	хурдасгагчийг	N;ACC;SG
слайд	слайдаа	N;VOC;SG
бүргэд	бүргэдээ	N;VOC;SG
батжилт	батжилтаар	N;INS;SG
мөчлөг	мөчлөгийн	N;GEN;SG
нөхөр	нөхрийг	N;ACC;SG
геологи	геологийн	N;GEN;SG
харамсал	харамслыг	N;ACC;SG
зөн	зөнгийн	N;GEN;SG
зочин	зочноо	N;VOC;SG
үүрэг	үүргийн	N;GEN;SG
өчиг	өчгийн	N;GEN;SG
шавар	шавраа	N;VOC;SG
дуулаач	дуулаачаа	N;VOC;SG
ирц	ирцийн	N;GEN;SG
ээж	ээжээс	N;ABL;SG
үү	үүнээс	N;ABL;SG
хавсралт	хавсралтаа	N;VOC;SG
зардал	зардлаас	N;ABL;SG
ерөнхийлөгч	ерөнхийлөгчөө	N;VOC;SG
шалгагч	шалгагчийг	N;ACC;SG
радио	радиогийн	N;GEN;SG
ширээ	ширээний	N;GEN;SG
манлайлагч	манлайлагчаас	N;ABL;SG
пүрш	пүршийг	N;ACC;SG
хоосрох	хоосров	V;PRF;IND;PRS
уртраг	уртрагийг	N;ACC;SG
оператор	оператораас	N;ABL;SG
нуур	нуурын	N;GEN;SG
нэмэлт	нэмэлтийн	N;GEN;SG
зөрөлдөөн	зөрөлдөөнийг	N;ACC;SG
тохуу	тохууг	N;ACC;SG
бүтэц	бүтцийн	N;GEN;SG
үзүүлбэр	үзүүлбэрийн	N;GEN;SG
мөс	мөснөөс	N;ABL;SG
гургуул	гургуулаар	N;INS;SG
халбага	халбаганаас	N;ABL;SG
өрөмдлөг	өрөмдлөгийн	N;GEN;SG
авьяастан	авьяастнаар	N;INS;SG
адар	адрыг	N;ACC;SG
эзэгнэл	эзэгнэлээ	N;VOC;SG
саун	сауныг	N;ACC;SG
хөнгөлөлт	хөнгөлөлтийг	N;ACC;SG
цэр	цэрний	N;GEN;SG
гамшиг	гамшгаар	N;INS;SG
атираа	атираагаа	N;VOC;SG
гинж	гинжийг	N;ACC;SG
хэрэглэгч	хэрэглэгчээ	N;VOC;SG
шат	шатаа	N;VOC;SG
шувуу	шувууг	N;ACC;SG
мөнгө	мөнгөний	N;GEN;SG
мужаан	мужааныг	N;ACC;SG
хиам	хиамны	N;GEN;SG
жүчээ	жүчээгээ	N;VOC;SG
жаяг	жаягаас	N;ABL;SG
тоглолт	тоглолтоо	N;VOC;SG
адгуус	адгуусны	N;GEN;SG
гуниг	гунигийн	N;GEN;SG
хийл	хийлээр	N;INS;SG
ганхалт	ганхалтыг	N;ACC;SG
хасагдагч	хасагдагчийн	N;GEN;SG
дураараа	дураа	N;VOC;SG
хөөрөлт	хөөрөлтөөс	N;ABL;SG
тэвхдэх	тэвхэджээ	V;IND;PST
шрифт	шрифтээ	N;VOC;SG
холболт	холболтоос	N;ABL;SG
мөөг	мөөгөө	N;VOC;SG
соронз	соронзыг	N;ACC;SG
хонго	хонгоор	N;INS;SG
зарга	заргаа	N;VOC;SG
найдвар	найдвараас	N;ABL;SG
мяндас	мяндсыг	N;ACC;SG
ачаа	ачааны	N;GEN;SG
харшилдаан	харшилдааны	N;GEN;SG
цохио	цохиогоор	N;INS;SG
шаналал	шаналлаар	N;INS;SG
хүлээс	хүлээсний	N;GEN;SG
таарамж	таарамжаар	N;INS;SG
хашлага	хашлагаар	N;INS;SG
тайрдас	тайрдсаар	N;INS;SG
зурах	зурсан	V;IND;PST
өөх	өөхөө	N;VOC;SG
солиорол	солиорлын	N;GEN;SG
өөдөс	өөдөснөөс	N;ABL;SG
эгнээ	эгнээгээ	N;VOC;SG
тулалдаан	тулалдаанаа	N;VOC;SG
өгүүлбэр	өгүүлбэрийн	N;GEN;SG
таамаг	таамгийн	N;GEN;SG
шош	шошоо	N;VOC;SG
дасгал	дасгалаар	N;INS;SG
адилсал	адилслын	N;GEN;SG
удирдагч	удирдагчийн	N;GEN;SG
нэгтгэл	нэгтгэлээ	N;VOC;SG
майонез	майонезаас	N;ABL;SG
гэдэс	гэдэсний	N;GEN;SG
удирдагч	удирдагчаар	N;INS;SG
хэрэгтэй	хэргээс	N;ABL;SG
болзол	болзлоо	N;VOC;SG
диск	дискээ	N;VOC;SG
сүүдрэвч	сүүдрэвчнээс	N;ABL;SG
өмч	өмчийн	N;GEN;SG
дэлгэц	дэлгэцээ	N;VOC;SG
мөхөөлдөс	мөхөөлдөснөөс	N;ABL;SG
явдал	явдлаа	N;VOC;SG
зохиомж	зохиомжоо	N;VOC;SG
хоньчин	хоньчны	N;GEN;SG
бүлүүр	бүлүүрийг	N;ACC;SG
хөргүүр	хөргүүрийг	N;ACC;SG
эм	эмийн	N;GEN;SG
цуу	цуугаар	N;INS;SG
нийтлэл	нийтлэлийг	N;ACC;SG
ангаахай	ангаахайгаар	N;INS;SG
үс	үснээс	N;ABL;SG
шош	шошийг	N;ACC;SG
дүрмийн	дүрмээр	N;INS;SG
эргүүлэг	эргүүлгийг	N;ACC;SG
оосор	оосроос	N;ABL;SG
багаж	багажаа	N;VOC;SG
үйлчлэгч	үйлчлэгчийн	N;GEN;SG
харьцуулал	харьцууллаа	N;VOC;SG
хоосрох	хоосорцгоо	V;IMP;PL;2;PRS
соронз	соронзоо	N;VOC;SG
цулбуур	цулбуурыг	N;ACC;SG
соруул	соруулаа	N;VOC;SG
молекул	молекулаар	N;INS;SG
хугарал	хугарлаас	N;ABL;SG
лаа	лааг	N;ACC;SG
орчуулга	орчуулгыг	N;ACC;SG
чавга	чавгаа	N;VOC;SG
урц	урцаа	N;VOC;SG
үзэм	үзмээр	N;INS;SG
шошго	шошгын	N;GEN;SG
хэсэг	хэсгийн	N;GEN;SG
томилгоо	томилгоог	N;ACC;SG
суралцагч	суралцагчийг	N;ACC;SG
таргалалт	таргалалтыг	N;ACC;SG
шургуулга	шургуулгаар	N;INS;SG
үйлчлэл	үйлчлэлээ	N;VOC;SG
шууданч	шууданчийг	N;ACC;SG
сэжүүр	сэжүүрийг	N;ACC;SG
зүүд	зүүдийг	N;ACC;SG
хими	химиэ	N;VOC;SG
хайгуул	хайгуулыг	N;ACC;SG
шүд	шүдний	N;GEN;SG
инээмсэглэл	инээмсэглэлийн	N;GEN;SG
хэмнэл	хэмнэлийн	N;GEN;SG
нөхцөл	нөхцөлийн	N;GEN;SG
егөө	егөөг	N;ACC;SG
ачлал	ачлалаа	N;VOC;SG
дамжуулагч	дамжуулагчийг	N;ACC;SG
ваар	ваарын	N;GEN;SG
коммунизм	коммунизмыг	N;ACC;SG
зардал	зардлыг	N;ACC;SG
стратеги	стратегиас	N;ABL;SG
дүн	дүнгээс	N;ABL;SG
бэлхүүс	бэлхүүсээ	N;VOC;SG
бүлэг	бүлгийн	N;GEN;SG
түрээс	түрээсээс	N;ABL;SG
бөмбөг	бөмбөгний	N;GEN;SG
дон	донг	N;ACC;SG
зээл	зээлээс	N;ABL;SG
төлөгч	төлөгчөө	N;VOC;SG
дадал	дадлаар	N;INS;SG
довцог	довцгоо	N;VOC;SG
нийтлэл	нийтлэлээс	N;ABL;SG
шороо	шороог	N;ACC;SG
амьтай	амийг	N;ACC;SG
зам	замаа	N;VOC;SG
харвалт	харвалтаас	N;ABL;SG
гүжирдлэг	гүжирдлэгээр	N;INS;SG
түрүү	түрүүг	N;ACC;SG
хамсаатан	хамсаатнаа	N;VOC;SG
тэрэг	тэрэгнээс	N;ABL;SG
үтрээ	үтрээгээр	N;INS;SG
төрөл	төрлөөр	N;INS;SG
мэргэжилтэн	мэргэжилтнийг	N;ACC;SG
эндэл	эндлээ	N;VOC;SG
төлөв	төлөвөөр	N;INS;SG
эвэр	эврээ	N;VOC;SG
гарц	гарцаар	N;INS;SG
ван	вангаа	N;VOC;SG
мөргөлчин	мөргөлчнөөс	N;ABL;SG
хамгаалагч	хамгаалагчаа	N;VOC;SG
салаа	салааны	N;GEN;SG
машин	машинаа	N;VOC;SG
бэхжилт	бэхжилтээ	N;VOC;SG
ярилцлага	ярилцлагаас	N;ABL;SG
үргээгч	үргээгчээс	N;ABL;SG
намар	намрын	N;GEN;SG
тагтаа	тагтааны	N;GEN;SG
залхуурал	залхуурлыг	N;ACC;SG
хормой	хормойгоор	N;INS;SG
далайц	далайцын	N;GEN;SG
хана	хананаас	N;ABL;SG
амьдрал	амьдралыг	N;ACC;SG
аюул	аюулаар	N;INS;SG
үзлэг	үзлэгээр	N;INS;SG
чихэр	чихрийн	N;GEN;SG
луус	луусыг	N;ACC;SG
гуйлт	гуйлтыг	N;ACC;SG
протокол	протоколоос	N;ABL;SG
гавал	гавлыг	N;ACC;SG
цоож	цоожийг	N;ACC;SG
будаг	будгийн	N;GEN;SG
зураас	зураасыг	N;ACC;SG
үржвэр	үржвэрийг	N;ACC;SG
зугаа	зугаагаар	N;INS;SG
шивэгчин	шивэгчнээр	N;INS;SG
цохих	цохив	V;PRF;IND;PRS
кофе	кофеноос	N;ABL;SG
шандас	шандсаар	N;INS;SG
илгээгч	илгээгчээ	N;VOC;SG
туяа	туяаны	N;GEN;SG
хонх	хонхноос	N;ABL;SG
карт	картын	N;GEN;SG
хүчтэй	хүчээр	N;INS;SG
эмээл	эмээлийг	N;ACC;SG
робот	роботын	N;GEN;SG
хушга	хушганы	N;GEN;SG
салтаа	салтааны	N;GEN;SG
эсэргүүцэл	эсэргүүцлийг	N;ACC;SG
хөгжимчин	хөгжимчнийг	N;ACC;SG
алиалагч	алиалагчаас	N;ABL;SG
торгууль	торгуулиа	N;VOC;SG
уулзвар	уулзвараас	N;ABL;SG
үечлэл	үечлэлээр	N;INS;SG
худалдаа	худалдаагаа	N;VOC;SG
гол	голоос	N;ABL;SG
сонирхол	сонирхлоор	N;INS;SG
солиорол	солиорлоор	N;INS;SG
зуун	зууныг	N;ACC;SG
хэлэлцэгч	хэлэлцэгчийг	N;ACC;SG
баяр	баяраас	N;ABL;SG
үүсгүүр	үүсгүүрийн	N;GEN;SG
хоцрогдол	хоцрогдлын	N;GEN;SG
алдартан	алдартнаар	N;INS;SG
энэрэл	энэрлийн	N;GEN;SG
пин	пингээр	N;INS;SG
хаягдал	хаягдлаа	N;VOC;SG
өмхий	өмхийийн	N;GEN;SG
капитализм	капитализмаа	N;VOC;SG
оршил	оршлоор	N;INS;SG
алдаа	алдаагаа	N;VOC;SG
залгаас	залгаасыг	N;ACC;SG
зурагчин	зурагчныг	N;ACC;SG
шохой	шохойгоос	N;ABL;SG
атом	атомоос	N;ABL;SG
тэг	тэгээр	N;INS;SG
тэнхлэг	тэнхлэгийн	N;GEN;SG
хорих	хоривол	V.CVB;LGSPEC03
шунал	шуналын	N;GEN;SG
хурдасгуур	хурдасгуурын	N;GEN;SG
томилгоо	томилгооны	N;GEN;SG
ширэг	ширгээр	N;INS;SG
дархлаа	дархлааны	N;GEN;SG
сал	салын	N;GEN;SG
ёжлол	ёжлолоо	N;VOC;SG
цааз	цаазаа	N;VOC;SG
хэрчим	хэрчмээ	N;VOC;SG
мөрдөгч	мөрдөгчийг	N;ACC;SG
нэхий	нэхийгээ	N;VOC;SG
зүйл	зүйлээ	N;VOC;SG
сэжиг	сэжгээ	N;VOC;SG
орогнох	товойсон	V;IND;PST
гэрээ	гэрээний	N;GEN;SG
шаналал	шаналлыг	N;ACC;SG
шаантаг	шаантгийн	N;GEN;SG
трамвай	трамвайг	N;ACC;SG
эрхшээл	эрхшээлээр	N;INS;SG
масло	маслоаа	N;VOC;SG
хатуурал	хатуурлаа	N;VOC;SG
орц	орцоор	N;INS;SG
хүн	хүний	N;GEN;SG
шөл	шөлний	N;GEN;SG
он	оноо	N;VOC;SG
эрэгчин	эрэгчнийг	N;ACC;SG
луужин	луужинг	N;ACC;SG
салтаа	салтаанаас	N;ABL;SG
нян	нянгаар	N;INS;SG
хэвлэлт	хэвлэлтийн	N;GEN;SG
дархлаа	дархлаагаа	N;VOC;SG
тунхаг	тунхгийг	N;ACC;SG
ширээс	ширээсээр	N;INS;SG
амьдчилал	амьдчиллаа	N;VOC;SG
хойг	хойгийн	N;GEN;SG
өмсгөл	өмсгөлийн	N;GEN;SG
өнгөлөх	өнгөлсөн	V;IND;PST
эрэмбэ	эрэмбийн	N;GEN;SG
атга	атгаар	N;INS;SG
үер	үерээс	N;ABL;SG
сонсогч	сонсогчийг	N;ACC;SG
тунадас	тунадсыг	N;ACC;SG
хүндэтгэлтэй	хүндэтгэлийн	N;GEN;SG
хэсэг	хэсгийг	N;ACC;SG
бүртгэл	бүртгэлээ	N;VOC;SG
цохио	цохиогоо	N;VOC;SG
баримтлал	баримтлалыг	N;ACC;SG
багц	багцыг	N;ACC;SG
мандолин	мандолинаа	N;VOC;SG
жараахай	жараахайгаа	N;VOC;SG
өөрчлөгч	өөрчлөгчөөс	N;ABL;SG
өрөмдлөг	өрөмдлөгөөс	N;ABL;SG
нуруу	нурууг	N;ACC;SG
анчин	анчнаа	N;VOC;SG
шөвхлөх	шөвхлөв	V;PRF;IND;PRS
томуу	томууны	N;GEN;SG
үүсвэр	үүсвэрийг	N;ACC;SG
хямдрал	хямдралаар	N;INS;SG
бүтэц	бүтцийг	N;ACC;SG
эргүү	эргүүгээ	N;VOC;SG
самбар	самбарын	N;GEN;SG
хямрал	хямралыг	N;ACC;SG
онол	онолоор	N;INS;SG
маркетинг	маркетингаа	N;VOC;SG
завхрал	завхралаа	N;VOC;SG
уршиг	уршгийн	N;GEN;SG
байдал	байдлын	N;GEN;SG
далдлалт	далдлалтаар	N;INS;SG
ахмад	ахмадаа	N;VOC;SG
аймшигтай	аймшгаа	N;VOC;SG
зөөгч	зөөгчөөр	N;INS;SG
соронз	соронзоор	N;INS;SG
драм	драмаас	N;ABL;SG
агуулах	агуулахын	N;GEN;SG
инээдэм	инээдмээ	N;VOC;SG
асуулга	асуулгын	N;GEN;SG
пост	постоо	N;VOC;SG
хана	ханаар	N;INS;SG
балет	балетаа	N;VOC;SG
үйлчилгээ	үйлчилгээнээс	N;ABL;SG
титэм	титмийг	N;ACC;SG
үечлэл	үечлэлийн	N;GEN;SG
багана	баганаа	N;VOC;SG
зориг	зоригоор	N;INS;SG
жатга	жатгаар	N;INS;SG
гажиг	гажгаар	N;INS;SG
цавь	цавиар	N;INS;SG
нуур	нуураар	N;INS;SG
зүйл	зүйлээр	N;INS;SG
нягтаршил	нягтаршлаар	N;INS;SG
хязгаарлал	хязгаарлалын	N;GEN;SG
жигшил	жигшлээр	N;INS;SG
сөнөөгч	сөнөөгчийн	N;GEN;SG
шүвтэр	шүвтрийн	N;GEN;SG
сүрэг	сүргийн	N;GEN;SG
иллэг	иллэгээс	N;ABL;SG
зурах	зурвал	V.CVB;LGSPEC03
хавтан	хавтангаас	N;ABL;SG
хөг	хөгийг	N;ACC;SG
шүлэгч	шүлэгчийн	N;GEN;SG
талх	талхыг	N;ACC;SG
жигнэмэг	жигнэмгээс	N;ABL;SG
ордон	ордныг	N;ACC;SG
сануулга	сануулгын	N;GEN;SG
тахих	тахивал	V.CVB;LGSPEC03
царцаа	царцаагаа	N;VOC;SG
нуруу	нуруунаас	N;ABL;SG
цус	цусаар	N;INS;SG
хуанли	хуанлиа	N;VOC;SG
ертөнц	ертөнцөөр	N;INS;SG
зотон	зотонгоос	N;ABL;SG
уяа	уяагаа	N;VOC;SG
санаачлагч	санаачлагчаа	N;VOC;SG
гудас	гудасыг	N;ACC;SG
нийлүүлэлт	нийлүүлэлтийг	N;ACC;SG
шрифт	шрифтийг	N;ACC;SG
царай	царайгаар	N;INS;SG
гэр	гэрээс	N;ABL;SG
амралт	амралтыг	N;ACC;SG
цуврал	цувралаар	N;INS;SG
маажин	маажингаа	N;VOC;SG
жич	жичээ	N;VOC;SG
үзэмж	үзэмжээ	N;VOC;SG
илүүдэл	илүүдлийг	N;ACC;SG
гариг	гаригаас	N;ABL;SG
сэтгүүл	сэтгүүлийн	N;GEN;SG
хагацал	хагацлыг	N;ACC;SG
тэлэлт	тэлэлтээ	N;VOC;SG
найртай	найрыг	N;ACC;SG
суутгал	суутгалаа	N;VOC;SG
ялгаруулалт	ялгаруулалтаас	N;ABL;SG
эрхшээл	эрхшээлээ	N;VOC;SG
олтриг	олтригоор	N;INS;SG
жолооч	жолоочоо	N;VOC;SG
босуул	босуулыг	N;ACC;SG
зориг	зоригоос	N;ABL;SG
шандас	шандаснаас	N;ABL;SG
зараа	зарааны	N;GEN;SG
харшилдаан	харшилдаанаа	N;VOC;SG
айзам	айзмын	N;GEN;SG
зарга	заргыг	N;ACC;SG
амьдчилал	амьдчиллаар	N;INS;SG
нотлох	нотолсон	V;IND;PST
араа	араагаа	N;VOC;SG
ван	вангийн	N;GEN;SG
жүчээ	жүчээнээс	N;ABL;SG
шүүс	шүүсний	N;GEN;SG
залгамжлал	залгамжлалаас	N;ABL;SG
ядаргаа	ядаргааны	N;GEN;SG
буурь	бууринаас	N;ABL;SG
гүн	гүнг	N;ACC;SG
хушга	хушганаас	N;ABL;SG
чөлөө	чөлөөгөөр	N;INS;SG
цагдаа	цагдаагаас	N;ABL;SG
нотлох	нотолчих	V;IMP;SG+PL;2
гаслан	гаслангаас	N;ABL;SG
харуул	харуулаас	N;ABL;SG
боржин	боржинг	N;ACC;SG
эрхлэгч	эрхлэгчийг	N;ACC;SG
хавирга	хавирганаас	N;ABL;SG
хавчаар	хавчаараар	N;INS;SG
зүлгүүр	зүлгүүрээр	N;INS;SG
талийгаач	талийгаачийн	N;GEN;SG
эмгэнэл	эмгэнэлээр	N;INS;SG
хурандаа	хурандаагаа	N;VOC;SG
шүршүүр	шүршүүрийг	N;ACC;SG
үлгэр	үлгэрээ	N;VOC;SG
гачигдал	гачигдлын	N;GEN;SG
үнсэлт	үнсэлтийн	N;GEN;SG
хэрэг	хэргийг	N;ACC;SG
аялга	аялгаа	N;VOC;SG
диск	дискийг	N;ACC;SG
дэн	дэнгээ	N;VOC;SG
шүүгээ	шүүгээний	N;GEN;SG
ядаргаа	ядаргааг	N;ACC;SG
шинэтгэл	шинэтгэлийн	N;GEN;SG
гол	голоо	N;VOC;SG
гахиур	гахиураа	N;VOC;SG
өрсөлдөөн	өрсөлдөөний	N;GEN;SG
зуун	зуунаас	N;ABL;SG
тэргүүлэгч	тэргүүлэгчээр	N;INS;SG
ногдол	ногдлыг	N;ACC;SG
амталгаа	амталгаанаас	N;ABL;SG
жагсаал	жагсаалаа	N;VOC;SG
амьдрал	амьдралаас	N;ABL;SG
судал	судлаар	N;INS;SG
зогсоц	зогсцоор	N;INS;SG
найруулагч	найруулагчаа	N;VOC;SG
хашаа	хашааг	N;ACC;SG
бичээч	бичээчээ	N;VOC;SG
тэрэг	тэргээр	N;INS;SG
сэтгэгдэл	сэтгэгдлээ	N;VOC;SG
ижилсэл	ижилслээр	N;INS;SG
нийлүүлэлт	нийлүүлэлтээр	N;INS;SG
угсралт	угсралтыг	N;ACC;SG
төлөөс	төлөөсний	N;GEN;SG
цэцэрлэг	цэцэрлэгээр	N;INS;SG
орчуулга	орчуулгын	N;GEN;SG
эгч	эгчээр	N;INS;SG
мөрдлөг	мөрдлөгийг	N;ACC;SG
эрхэс	эрхсээс	N;ABL;SG
угтвар	угтвараа	N;VOC;SG
талбай	талбайнаас	N;ABL;SG
хэмжигдэхүүн	хэмжигдэхүүнээр	N;INS;SG
ээрүүл	ээрүүлийн	N;GEN;SG
өсөлт	өсөлтөөр	N;INS;SG
зэвүүцэл	зэвүүцлийг	N;ACC;SG
өсөлт	өсөлтийн	N;GEN;SG
маск	маскаар	N;INS;SG
хавч	хавчаа	N;VOC;SG
программ	программаа	N;VOC;SG
заншил	заншлаар	N;INS;SG
харилцаа	харилцаагаар	N;INS;SG
санхүүч	санхүүчийн	N;GEN;SG
зөвлөл	зөвлөлөө	N;VOC;SG
фермент	ферментийн	N;GEN;SG
ажиллагаа	ажиллагааны	N;GEN;SG
арш	аршийн	N;GEN;SG
баримжаа	баримжаагаа	N;VOC;SG
бөөндөх	бөөндвөл	V.CVB;LGSPEC03
явц	явцаа	N;VOC;SG
явуулга	явуулгыг	N;ACC;SG
саван	савангийн	N;GEN;SG
кофе	кофены	N;GEN;SG
заламгай	заламгайнаас	N;ABL;SG
студи	студиэр	N;INS;SG
сүлжээ	сүлжээнээс	N;ABL;SG
захирамж	захирамжийн	N;GEN;SG
гирвэших	гирвэшив	V;PRF;IND;PRS
гимнастик	гимнастикаас	N;ABL;SG
сүнс	сүнсээ	N;VOC;SG
гуйлга	гуйлгаас	N;ABL;SG
ноорог	нооргоо	N;VOC;SG
тасалбар	тасалбарыг	N;ACC;SG
им	имээс	N;ABL;SG
үүргэвч	үүргэвчийг	N;ACC;SG
даруулгатай	даруулгаас	N;ABL;SG
илэрхийлэл	илэрхийллээ	N;VOC;SG
илээч	илээчийн	N;GEN;SG
банзал	банзлаар	N;INS;SG
дүүжин	дүүжингээ	N;VOC;SG
орлого	орлогын	N;GEN;SG
нуур	нуурыг	N;ACC;SG
дамнуурга	дамнуургаа	N;VOC;SG
хуваагдал	хуваагдлаас	N;ABL;SG
завхайрал	завхайрлаа	N;VOC;SG
зэрэглэл	зэрэглэлээс	N;ABL;SG
тэтгэмж	тэтгэмжээр	N;INS;SG
амьсгал	амьсгалын	N;GEN;SG
атом	атомоо	N;VOC;SG
дээрэм	дээрмийн	N;GEN;SG
зээтүү	зээтүүний	N;GEN;SG
гэргий	гэргийгээ	N;VOC;SG
багтаамж	багтаамжаас	N;ABL;SG
хэрэгсэл	хэрэгслээс	N;ABL;SG
өвгөн	өвгөнөөр	N;INS;SG
шүршигч	шүршигчийн	N;GEN;SG
хакер	хакерыг	N;ACC;SG
дэвсгэр	дэвсгэрээ	N;VOC;SG
туяа	туяагаар	N;INS;SG
ихэс	ихсээ	N;VOC;SG
цаас	цаасаа	N;VOC;SG
донтон	донтноос	N;ABL;SG
үлдэгдэл	үлдэгдлээр	N;INS;SG
хуйлаас	хуйлаасаар	N;INS;SG
охин	охины	N;GEN;SG
орлогч	орлогчоо	N;VOC;SG
номлол	номлолоос	N;ABL;SG
бэлхүүс	бэлхүүсээр	N;INS;SG
маажин	маажингаар	N;INS;SG
рационализм	рационализмын	N;GEN;SG
бариа	барианы	N;GEN;SG
бэрх	бэрхээс	N;ABL;SG
сууц	сууцаас	N;ABL;SG
удирдамж	удирдамжийг	N;ACC;SG
илбэ	илбээс	N;ABL;SG
оператор	оператораар	N;INS;SG
амьтан	амьтнаас	N;ABL;SG
бодис	бодисоо	N;VOC;SG
эвдчих	эвдчив	V;PRF;IND;PRS
зураас	зураасаар	N;INS;SG
айзам	айзмаа	N;VOC;SG
атаархал	атаархлаа	N;VOC;SG
ургац	ургацын	N;GEN;SG
хөгжимчин	хөгжимчнөөс	N;ABL;SG
урлаг	урлагаа	N;VOC;SG
ул	улнаас	N;ABL;SG
дарангуйлагч	дарангуйлагчаар	N;INS;SG
эзэгнэл	эзэгнэлийн	N;GEN;SG
дэмжигч	дэмжигчийн	N;GEN;SG
чөлөөтэй	чөлөөнөөс	N;ABL;SG
төвлөрүүлэлт	төвлөрүүлэлтийг	N;ACC;SG
хугарал	хугарлын	N;GEN;SG
үртэс	үртсээ	N;VOC;SG
шоглоом	шоглоомоор	N;INS;SG
бизнес	бизнесийн	N;GEN;SG
зарц	зарцаас	N;ABL;SG
сорох	сорсон	V;IND;PST
эрэлт	эрэлтээр	N;INS;SG
дамжуулагч	дамжуулагчийн	N;GEN;SG
өгөгдөл	өгөгдлөөр	N;INS;SG
тууль	туулийг	N;ACC;SG
шохойжих	шохойжвол	V.CVB;LGSPEC03
өөрчлөл	өөрчлөлийг	N;ACC;SG
үнэг	үнэгээс	N;ABL;SG
том	томоо	N;VOC;SG
туршилт	туршилтыг	N;ACC;SG
даяарших	даяаршвал	V.CVB;LGSPEC03
өтгөн	өтгөнөөс	N;ABL;SG
хөдөлмөр	хөдөлмөрийн	N;GEN;SG
төсөв	төсвийг	N;ACC;SG
эслэг	эслэгийг	N;ACC;SG
цуурга	цуурганаас	N;ABL;SG
вальс	вальсаар	N;INS;SG
мэндчилгээ	мэндчилгээний	N;GEN;SG
аалз	аалзыг	N;ACC;SG
эрдэнэс	эрдэнэсийн	N;GEN;SG
даяан	даяанаас	N;ABL;SG
шунал	шуналаар	N;INS;SG
төлбөр	төлбөрийн	N;GEN;SG
салбар	салбарыг	N;ACC;SG
сайд	сайдын	N;GEN;SG
хавчлага	хавчлагаар	N;INS;SG
үнэмшил	үнэмшлээ	N;VOC;SG
гагнуурчин	гагнуурчныг	N;ACC;SG
майхан	майхны	N;GEN;SG
дүрслэл	дүрслэлээс	N;ABL;SG
хирс	хирсээ	N;VOC;SG
сурагч	сурагчаас	N;ABL;SG
шархлаа	шархлаагаа	N;VOC;SG
янхан	янхнаар	N;INS;SG
дусал	дуслаа	N;VOC;SG
фракц	фракцаа	N;VOC;SG
санал	саналын	N;GEN;SG
хийл	хийлийн	N;GEN;SG
зэмлэл	зэмлэлийн	N;GEN;SG
тосгуур	тосгуурыг	N;ACC;SG
цаас	цааснаас	N;ABL;SG
гаргалт	гаргалтыг	N;ACC;SG
гадарга	гадаргыг	N;ACC;SG
арилжаа	арилжааны	N;GEN;SG
цуглаан	цуглаанаар	N;INS;SG
илжиг	илжгийг	N;ACC;SG
нугас	нугасаар	N;INS;SG
хилэгнэл	хилэгнэлийг	N;ACC;SG
нүдтэй	нүдээ	N;VOC;SG
зугаа	зугааг	N;ACC;SG
сургамж	сургамжийн	N;GEN;SG
өсгий	өсгийгөөр	N;INS;SG
хожуул	хожуулаа	N;VOC;SG
эрхшээл	эрхшээлээс	N;ABL;SG
ачаа	ачаанаас	N;ABL;SG
хариу	хариунаас	N;ABL;SG
үржвэр	үржвэрийн	N;GEN;SG
хөгжим	хөгжмөө	N;VOC;SG
социализм	социализмын	N;GEN;SG
радиус	радиусыг	N;ACC;SG
гадас	гадаснаас	N;ABL;SG
мах	махаар	N;INS;SG
илд	илднээс	N;ABL;SG
зогдор	зогдроор	N;INS;SG
мануухай	мануухайнаас	N;ABL;SG
сүлжээ	сүлжээгээр	N;INS;SG
биелэлт	биелэлтийн	N;GEN;SG
таамаглал	таамаглалаа	N;VOC;SG
хэлэхүй	хэлэхүйгээс	N;ABL;SG
лоозон	лоозонгоо	N;VOC;SG
капсул	капсулаар	N;INS;SG
тэнүүл	тэнүүлийн	N;GEN;SG
шийд	шийдээр	N;INS;SG
хуваарилалт	хуваарилалтаа	N;VOC;SG
хариуцлага	хариуцлагын	N;GEN;SG
захиргаа	захиргаагаар	N;INS;SG
хуримтлал	хуримтлалаас	N;ABL;SG
гинж	гинжээ	N;VOC;SG
цайз	цайзыг	N;ACC;SG
аялал	аяллаас	N;ABL;SG
төсөл	төслийг	N;ACC;SG
трансформатор	трансформаторын	N;GEN;SG
дэгээ	дэгээгээ	N;VOC;SG
гарал	гарлаас	N;ABL;SG
хувьсгагч	хувьсгагчийн	N;GEN;SG
иллэг	иллэгээ	N;VOC;SG
бариа	бариагаа	N;VOC;SG
дун	дунгийн	N;GEN;SG
зууш	зуушнаас	N;ABL;SG
шугам	шугамаас	N;ABL;SG
шоргоолж	шоргоолжноос	N;ABL;SG
иш	ишийг	N;ACC;SG
дээс	дээсээр	N;INS;SG
бөглөө	бөглөөгөө	N;VOC;SG
магадлал	магадлалыг	N;ACC;SG
томуу	томуугаа	N;VOC;SG
тойрог	тойргоо	N;VOC;SG
мансуурал	мансуурлаас	N;ABL;SG
ходоод	ходоодоо	N;VOC;SG
суман	сумангаар	N;INS;SG
цуглуулагч	цуглуулагчаас	N;ABL;SG
төмс	төмсөөр	N;INS;SG
амттан	амттанаа	N;VOC;SG
дүрвэгч	дүрвэгчээс	N;ABL;SG
булингар	булингарыг	N;ACC;SG
дөнжөө	дөнжөөс	N;ABL;SG
заавар	зааврын	N;GEN;SG
ах	ахыг	N;ACC;SG
тусгал	тусгалаас	N;ABL;SG
үзлэг	үзлэгийг	N;ACC;SG
тал	талаа	N;VOC;SG
спирт	спиртээр	N;INS;SG
гурвал	гурвалаар	N;INS;SG
чуулга	чуулгын	N;GEN;SG
устгагч	устгагчийг	N;ACC;SG
ажилтан	ажилтнаа	N;VOC;SG
шатаагч	шатаагчаас	N;ABL;SG
залгавар	залгаврыг	N;ACC;SG
мөс	мөсөөр	N;INS;SG
жанжин	жанжнаа	N;VOC;SG
ирвэгэнэх	ирвэгэнэцгээ	V;IMP;PL;2;PRS
тос	тосыг	N;ACC;SG
ялагдагч	ялагдагчаас	N;ABL;SG
тулгуур	тулгуурын	N;GEN;SG
хашлага	хашлаганаас	N;ABL;SG
хулуу	хулуугаар	N;INS;SG
амт	амтнаас	N;ABL;SG
текст	текстээр	N;INS;SG
акт	актаас	N;ABL;SG
гуя	гуяаар	N;INS;SG
егөө	егөөнөөс	N;ABL;SG
хацар	хацраар	N;INS;SG
тусгал	тусгалыг	N;ACC;SG
луйвар	луйвраар	N;INS;SG
тогтворжуулалт	тогтворжуулалтыг	N;ACC;SG
инээмсэглэл	инээмсэглэлээр	N;INS;SG
эд	эдээс	N;ABL;SG
тэнүүл	тэнүүлээ	N;VOC;SG
зугтлага	зугтлагаас	N;ABL;SG
гэрлэлт	гэрлэлтийг	N;ACC;SG
организм	организмыг	N;ACC;SG
дэлгүүр	дэлгүүрийг	N;ACC;SG
завь	завийг	N;ACC;SG
талбай	талбайг	N;ACC;SG
диаграмм	диаграммаас	N;ABL;SG
исэг	исгээр	N;INS;SG
ухралт	ухралтын	N;GEN;SG
төмс	төмсний	N;GEN;SG
гэмтэл	гэмтлийн	N;GEN;SG
дутагдал	дутагдлаас	N;ABL;SG
гурил	гурилыг	N;ACC;SG
ноёрхол	ноёрхлыг	N;ACC;SG
өргөтгөл	өргөтгөлөөс	N;ABL;SG
зээл	зээлийг	N;ACC;SG
хязгаарлалт	хязгаарлалтаар	N;INS;SG
газар	газраас	N;ABL;SG
философи	философиор	N;INS;SG
үсрэлт	үсрэлтээс	N;ABL;SG
шийр	шийрийг	N;ACC;SG
бэлхүүсэвч	бэлхүүсэвчийн	N;GEN;SG
ором	ормоо	N;VOC;SG
хурал	хурлыг	N;ACC;SG
бодрол	бодролыг	N;ACC;SG
шалгалт	шалгалтаар	N;INS;SG
тагнуул	тагнуулаар	N;INS;SG
сэдэл	сэдлийг	N;ACC;SG
ерөнхийлөгч	ерөнхийлөгчөөр	N;INS;SG
хэрүүл	хэрүүлээ	N;VOC;SG
амьдчилал	амьдчиллын	N;GEN;SG
хаан	хааныг	N;ACC;SG
ургамал	ургамлаар	N;INS;SG
хатуулга	хатуулгаа	N;VOC;SG
шат	шатаар	N;INS;SG
исэлт	исэлтээ	N;VOC;SG
хонго	хонгоо	N;VOC;SG
тоолуур	тоолуураас	N;ABL;SG
нотлох	нотолцгоо	V;IMP;PL;2;PRS
давхраа	давхраагаа	N;VOC;SG
зотон	зотонгоо	N;VOC;SG
ангаахай	ангаахайгаа	N;VOC;SG
хурандаа	хурандаагаар	N;INS;SG
мэдээлэх	мэдээлэв	V;PRF;IND;PRS
архичин	архичнаас	N;ABL;SG
үйс	үйсээр	N;INS;SG
нэхий	нэхийгээр	N;INS;SG
ашиг	ашгаа	N;VOC;SG
карантин	карантинаар	N;INS;SG
хувьсал	хувьслаар	N;INS;SG
саад	саадаа	N;VOC;SG
хэрэгтэй	хэргийг	N;ACC;SG
маркетинг	маркетингийн	N;GEN;SG
гайхамшиг	гайхамшгаас	N;ABL;SG
цохилт	цохилтыг	N;ACC;SG
зоодой	зоодойг	N;ACC;SG
дарангуйлал	дарангуйллаа	N;VOC;SG
дамжуулалт	дамжуулалтаа	N;VOC;SG
индүүдлэг	индүүдлэгээ	N;VOC;SG
зохицол	зохицлоос	N;ABL;SG
асуулга	асуулгаар	N;INS;SG
төсөөлөл	төсөөллөөс	N;ABL;SG
зохицол	зохицлын	N;GEN;SG
өв	өвөөс	N;ABL;SG
трансформатор	трансформатораа	N;VOC;SG
бэлгэдэл	бэлгэдлээр	N;INS;SG
дүрмийн	дүрмийн	N;GEN;SG
устгагч	устгагчийн	N;GEN;SG
санхүү	санхүүгээс	N;ABL;SG
бүйлс	бүйлсээр	N;INS;SG
ногдол	ногдлоос	N;ABL;SG
бяслаг	бяслагаас	N;ABL;SG
хоцрогч	хоцрогчоо	N;VOC;SG
гуйлга	гуйлгын	N;GEN;SG
харилцуур	харилцуурын	N;GEN;SG
тунадас	тунадсаа	N;VOC;SG
гох	гохны	N;GEN;SG
зарга	заргын	N;GEN;SG
хэллэг	хэллэгээр	N;INS;SG
илбэчин	илбэчнийг	N;ACC;SG
нээлт	нээлтээс	N;ABL;SG
нум	нумны	N;GEN;SG
үндэс	үндэсний	N;GEN;SG
хүндэтгэл	хүндэтгэлийн	N;GEN;SG
услагч	услагчаа	N;VOC;SG
дэнлүү	дэнлүүг	N;ACC;SG
зүлэг	зүлгээр	N;INS;SG
дуализм	дуализмын	N;GEN;SG
курс	курсийг	N;ACC;SG
хун	хунгийн	N;GEN;SG
мах	махнаас	N;ABL;SG
цагдаа	цагдаагаа	N;VOC;SG
хянагч	хянагчийн	N;GEN;SG
ташуур	ташуураа	N;VOC;SG
тарга	таргаар	N;INS;SG
баримжаа	баримжааны	N;GEN;SG
эшлэл	эшлэлээр	N;INS;SG
хурдасгагч	хурдасгагчаа	N;VOC;SG
илд	илдийг	N;ACC;SG
захидал	захидлаар	N;INS;SG
цэрэг	цэргийг	N;ACC;SG
нэхий	нэхийг	N;ACC;SG
тэсрэлт	тэсрэлтээр	N;INS;SG
урвал	урвалыг	N;ACC;SG
хандив	хандивыг	N;ACC;SG
хакер	хакераа	N;VOC;SG
хөгтэй	хөгөөр	N;INS;SG
үнэр	үнэрээс	N;ABL;SG
итгэл	итгэлийг	N;ACC;SG
чихэр	чихрээс	N;ABL;SG
биелэлт	биелэлтийг	N;ACC;SG
өлсгөлөн	өлсгөлөнг	N;ACC;SG
хариуцагч	хариуцагчийг	N;ACC;SG
сорви	сорвийг	N;ACC;SG
хөгжилтэй	хөгжлөөр	N;INS;SG
онцлог	онцлогоо	N;VOC;SG
жад	жадаа	N;VOC;SG
ритм	ритмийн	N;GEN;SG
амбиц	амбицыг	N;ACC;SG
гагнуурчин	гагнуурчны	N;GEN;SG
тохироо	тохироог	N;ACC;SG
хорхой	хорхойгоос	N;ABL;SG
онцлог	онцлогоос	N;ABL;SG
ой	ойгоо	N;VOC;SG
редактор	редактораас	N;ABL;SG
тэг	тэгээс	N;ABL;SG
зүслэг	зүслэгээр	N;INS;SG
сөргөлдөөн	сөргөлдөөнөөр	N;INS;SG
баривчилгаа	баривчилгааны	N;GEN;SG
бухимдал	бухимдлаа	N;VOC;SG
биллиард	биллиардаар	N;INS;SG
ялгалт	ялгалтыг	N;ACC;SG
төмсөг	төмсгийн	N;GEN;SG
исэлдэлт	исэлдэлтээр	N;INS;SG
тоглолт	тоглолтыг	N;ACC;SG
өндгөвч	өндгөвчөөс	N;ABL;SG
шпагетти	шпагеттиар	N;INS;SG
өсгий	өсгийгөө	N;VOC;SG
цоглог	цоглогийн	N;GEN;SG
үсэг	үсгээ	N;VOC;SG
ижилсэл	ижилслийн	N;GEN;SG
тоглоом	тоглоомыг	N;ACC;SG
устгагч	устгагчаас	N;ABL;SG
зөрлөг	зөрлөгийг	N;ACC;SG
шумбагч	шумбагчийн	N;GEN;SG
ятгалга	ятгалгаас	N;ABL;SG
цагдаа	цагдаагаар	N;INS;SG
татвар	татвараа	N;VOC;SG
нягтшил	нягтшилаа	N;VOC;SG
гимнастик	гимнастикийг	N;ACC;SG
хэвийн	хэвийн	N;GEN;SG
амуу	амуугаар	N;INS;SG
царай	царайн	N;GEN;SG
идеализм	идеализмыг	N;ACC;SG
генерал	генералын	N;GEN;SG
бяслаг	бяслагаа	N;VOC;SG
харуусал	харууслын	N;GEN;SG
санхүү	санхүүгээр	N;INS;SG
өргөлт	өргөлтийг	N;ACC;SG
далайчин	далайчны	N;GEN;SG
үсэг	үсгээр	N;INS;SG
клиник	клиникээс	N;ABL;SG
хондлой	хондлойг	N;ACC;SG
багц	багцын	N;GEN;SG
дамжуулалт	дамжуулалтаас	N;ABL;SG
чийдэн	чийдэнгийн	N;GEN;SG
бай	байг	N;ACC;SG
өндгөвч	өндгөвчийн	N;GEN;SG
сэдэл	сэдлийн	N;GEN;SG
нас	насаа	N;VOC;SG
өлсгөлөн	өлсгөлөнгөөс	N;ABL;SG
тууралт	тууралтаар	N;INS;SG
хардлага	хардлагаас	N;ABL;SG
бүтэлгүйтэл	бүтэлгүйтлээр	N;INS;SG
холбоо	холбоог	N;ACC;SG
хохирол	хохирлоор	N;INS;SG
тамхи	тамхиар	N;INS;SG
тэжээл	тэжээлээ	N;VOC;SG
тусламж	тусламжийн	N;GEN;SG
эвтэй	эвээр	N;INS;SG
бээлий	бээлийгээр	N;INS;SG
хүүхэд	хүүхдээ	N;VOC;SG
там	тамаас	N;ABL;SG
цочрол	цочролоор	N;INS;SG
маргаан	маргааны	N;GEN;SG
хамтрагч	хамтрагчаас	N;ABL;SG
танилцуулга	танилцуулгаас	N;ABL;SG
шүүх	шүүхээр	N;INS;SG
продакшн	продакшнаас	N;ABL;SG
бослого	бослогыг	N;ACC;SG
радиатор	радиатораа	N;VOC;SG
тохируулга	тохируулгыг	N;ACC;SG
нүх	нүхний	N;GEN;SG
шон	шонгоос	N;ABL;SG
илгээгч	илгээгчийг	N;ACC;SG
тайлан	тайлангаас	N;ABL;SG
үеэл	үеэлээр	N;INS;SG
хөгжилтэй	хөгжлөөс	N;ABL;SG
цочрол	цочролыг	N;ACC;SG
капитализм	капитализмаас	N;ABL;SG
анализ	анализыг	N;ACC;SG
буртаг	буртгаар	N;INS;SG
хуйвалдаан	хуйвалдаанаа	N;VOC;SG
давтамж	давтамжийн	N;GEN;SG
тарилга	тарилгаас	N;ABL;SG
бокс	боксоор	N;INS;SG
шударга	шударгаас	N;ABL;SG
цаас	цаасыг	N;ACC;SG
зөвлөгөөн	зөвлөгөөнөөс	N;ABL;SG
жараахай	жараахайгаар	N;INS;SG
логик	логикоо	N;VOC;SG
зэв	зэвээс	N;ABL;SG
чихэр	чихрээр	N;INS;SG
харуусал	харууслыг	N;ACC;SG
залуур	залуурын	N;GEN;SG
зангиа	зангиагаар	N;INS;SG
ургац	ургацаа	N;VOC;SG
хувирал	хувирлын	N;GEN;SG
хохирол	хохирлоос	N;ABL;SG
шударга	шударгыг	N;ACC;SG
робот	роботоос	N;ABL;SG
эргүү	эргүүгээр	N;INS;SG
харьяалал	харьяаллаа	N;VOC;SG
дэмжлэг	дэмжлэгийг	N;ACC;SG
залгаа	залгааны	N;GEN;SG
аалз	аалзаар	N;INS;SG
хамсаатан	хамсаатнаар	N;INS;SG
ачлал	ачлалын	N;GEN;SG
намаг	намгийн	N;GEN;SG
гамшиг	гамшгийн	N;GEN;SG
статистик	статистикаа	N;VOC;SG
авгалдай	авгалдайгаа	N;VOC;SG
эргэлт	эргэлтээр	N;INS;SG
шуугиан	шуугианаас	N;ABL;SG
боргио	боргионы	N;GEN;SG
янхан	янхны	N;GEN;SG
адмирал	адмиралаа	N;VOC;SG
шүүмжлэгч	шүүмжлэгчийн	N;GEN;SG
асфальт	асфальтын	N;GEN;SG
холгодос	холгодсоор	N;INS;SG
пин	пингээс	N;ABL;SG
ургамал	ургамлаа	N;VOC;SG
хавтан	хавтангийн	N;GEN;SG
таргалалт	таргалалтын	N;GEN;SG
зэвсэг	зэвсгээ	N;VOC;SG
гарчиг	гарчгийн	N;GEN;SG
зүлгүүр	зүлгүүрээс	N;ABL;SG
ганхалт	ганхалтын	N;GEN;SG
мансуурал	мансуурлаа	N;VOC;SG
тохижуулалт	тохижуулалтаа	N;VOC;SG
занга	занганаас	N;ABL;SG
харьцуулал	харьцууллаас	N;ABL;SG
судар	судрыг	N;ACC;SG
тэмдэглэл	тэмдэглэлийн	N;GEN;SG
үйлчилгээ	үйлчилгээгээр	N;INS;SG
зохиол	зохиолоо	N;VOC;SG
эргэлзээ	эргэлзээгээ	N;VOC;SG
хальс	хальсаар	N;INS;SG
хуйвалдаан	хуйвалдааныг	N;ACC;SG
уул	уулаар	N;INS;SG
жорлон	жорлонгоор	N;INS;SG
аэробик	аэробикийн	N;GEN;SG
сүлбэлдээн	сүлбэлдээнээс	N;ABL;SG
шинэтгэл	шинэтгэлээр	N;INS;SG
трамвай	трамвайгаар	N;INS;SG
хамгаалалт	хамгаалалтаа	N;VOC;SG
зураг	зургаас	N;ABL;SG
тэврэлт	тэврэлтээс	N;ABL;SG
цохио	цохиог	N;ACC;SG
иш	ишээ	N;VOC;SG
зорилго	зорилгоо	N;VOC;SG
үзүүлэлт	үзүүлэлтийн	N;GEN;SG
мэхлэлт	мэхлэлтээс	N;ABL;SG
далан	далангаас	N;ABL;SG
тэмүүлэл	тэмүүллээс	N;ABL;SG
аврагч	аврагчийг	N;ACC;SG
баясал	баяслаас	N;ABL;SG
ирвэгэнэх	ирвэгэнэв	V;PRF;IND;PRS
уншигч	уншигчийг	N;ACC;SG
гараа	гараагаар	N;INS;SG
бөгж	бөгжөө	N;VOC;SG
тууль	туулиас	N;ABL;SG
халамж	халамжийн	N;GEN;SG
гэрч	гэрчийн	N;GEN;SG
гуа	гуанаас	N;ABL;SG
цөөрөм	цөөрмөөр	N;INS;SG
бонд	бондоор	N;INS;SG
хэвлий	хэвлийгээ	N;VOC;SG
дэлгэрэлт	дэлгэрэлтээс	N;ABL;SG
удамшил	удамшлыг	N;ACC;SG
ногт	ногтноос	N;ABL;SG
залгаа	залгаанаас	N;ABL;SG
хэрэгсэл	хэрэгслээ	N;VOC;SG
ихэс	ихсээр	N;INS;SG
эрэг	эргээс	N;ABL;SG
аюул	аюулыг	N;ACC;SG
хоншоор	хоншоорын	N;GEN;SG
гэгээрэл	гэгээрлээ	N;VOC;SG
туршуул	туршуулыг	N;ACC;SG
хэрчим	хэрчмийн	N;GEN;SG
урилга	урилгыг	N;ACC;SG
осол	ослын	N;GEN;SG
нөхцөл	нөхцөлийг	N;ACC;SG
ачаа	ачаагаа	N;VOC;SG
дэнс	дэнсээ	N;VOC;SG
хэмжүүр	хэмжүүрийг	N;ACC;SG
эрэл	эрлээ	N;VOC;SG
организм	организмын	N;GEN;SG
бассейн	бассейныг	N;ACC;SG
сүсэг	сүсгээс	N;ABL;SG
албажих	албажвал	V.CVB;LGSPEC03
үг	үгний	N;GEN;SG
аврал	авралыг	N;ACC;SG
улирал	улирлыг	N;ACC;SG
шийдвэрлэгч	шийдвэрлэгчийн	N;GEN;SG
линз	линзээс	N;ABL;SG
авьяастан	авьяастны	N;GEN;SG
хурдасгагч	хурдасгагчаас	N;ABL;SG
ялгаруулалт	ялгаруулалтыг	N;ACC;SG
явц	явцаас	N;ABL;SG
өгүүлэгдэхүүн	өгүүлэгдэхүүний	N;GEN;SG
үзүүлэлт	үзүүлэлтээр	N;INS;SG
хянагч	хянагчаар	N;INS;SG
эс	эсээ	N;VOC;SG
ая	аяын	N;GEN;SG
хагарал	хагарлаар	N;INS;SG
түрүү	түрүүний	N;GEN;SG
тэлэлт	тэлэлтээс	N;ABL;SG
хүрэм	хүрмээс	N;ABL;SG
хандив	хандиваас	N;ABL;SG
дилер	дилерээ	N;VOC;SG
чөлөө	чөлөөгөө	N;VOC;SG
зугтуул	зугтуулаа	N;VOC;SG
айдас	айдсын	N;GEN;SG
уулчин	уулчнаа	N;VOC;SG
үртэс	үртсийг	N;ACC;SG
иог	иогоор	N;INS;SG
хөөрөл	хөөрлөөр	N;INS;SG
тарилга	тарилгын	N;GEN;SG
шийдвэр	шийдвэрийг	N;ACC;SG
огтлолцол	огтлолцлоос	N;ABL;SG
клиник	клиникийн	N;GEN;SG
исэг	исгээ	N;VOC;SG
өнцөг	өнцгийг	N;ACC;SG
шавар	шавраар	N;INS;SG
харшил	харшлын	N;GEN;SG
зотон	зотонгоор	N;INS;SG
гавьяа	гавьяанаас	N;ABL;SG
цулбуур	цулбуураас	N;ABL;SG
багаж	багажийн	N;GEN;SG
шивэгчин	шивэгчнээс	N;ABL;SG
генерал	генералаас	N;ABL;SG
зөвлөгөөн	зөвлөгөөнөө	N;VOC;SG
сэлгээ	сэлгээнээс	N;ABL;SG
хоч	хочоо	N;VOC;SG
зээлдүүлэгч	зээлдүүлэгчээр	N;INS;SG
байцаагч	байцаагчаас	N;ABL;SG
эмээл	эмээлээс	N;ABL;SG
өгзөг	өгзгөө	N;VOC;SG
үзүүлэн	үзүүлэнг	N;ACC;SG
дууль	дуулийн	N;GEN;SG
ажилчин	ажилчнаас	N;ABL;SG
соёл	соёлыг	N;ACC;SG
ирвэгэнэх	хэлмэгджээ	V;IND;PST
сүлбэлдээн	сүлбэлдээний	N;GEN;SG
бөөгнөрөл	бөөгнөрлөө	N;VOC;SG
совин	совингоор	N;INS;SG
гэмтэл	гэмтлээр	N;INS;SG
босго	босгын	N;GEN;SG
өвдөг	өвдөгнөөс	N;ABL;SG
цаас	цаасаар	N;INS;SG
бамбар	бамбараар	N;INS;SG
бухимдал	бухимдлаас	N;ABL;SG
хатуулга	хатуулгаар	N;INS;SG
дулаарах	ажиллачих	V;IMP;SG+PL;2
дамжуулагч	дамжуулагчаас	N;ABL;SG
оёдол	оёдлоо	N;VOC;SG
нисгэгч	нисгэгчийг	N;ACC;SG
чулуу	чулууг	N;ACC;SG
нэвтрүүлэгч	нэвтрүүлэгчийн	N;GEN;SG
хөлс	хөлсөөр	N;INS;SG
амлалт	амлалтаас	N;ABL;SG
дохиолол	дохиоллын	N;GEN;SG
хууль	хуулиа	N;VOC;SG
хуйвалдаан	хуйвалдааны	N;GEN;SG
гарал	гарлаар	N;INS;SG
мэтгэлцээн	мэтгэлцээнээр	N;INS;SG
түлхүүр	түлхүүрийг	N;ACC;SG
нөлөө	нөлөөг	N;ACC;SG
сүүдэр	сүүдрээ	N;VOC;SG
мушгиа	мушгианаас	N;ABL;SG
ханш	ханшийн	N;GEN;SG
егөө	егөөгөөр	N;INS;SG
цөөрөм	цөөрмийг	N;ACC;SG
оромж	оромжийн	N;GEN;SG
буудлага	буудлагаар	N;INS;SG
гадуурхал	гадуурхлаас	N;ABL;SG
үйлдвэр	үйлдвэрээр	N;INS;SG
цөл	цөлөөс	N;ABL;SG
хөвгүүн	хөвгүүнээс	N;ABL;SG
талбар	талбарыг	N;ACC;SG
хөг	хөгөөр	N;INS;SG
хэмжээс	хэмжээсээр	N;INS;SG
ёслол	ёслолыг	N;ACC;SG
карантин	карантинаас	N;ABL;SG
шүд	шүдээр	N;INS;SG
янжуур	янжуурын	N;GEN;SG
тугалга	тугалгаа	N;VOC;SG
дам	дамаа	N;VOC;SG
орогнох	орогноцгоо	V;IMP;PL;2;PRS
хүрэм	хүрмээ	N;VOC;SG
эрэгчин	эрэгчний	N;GEN;SG
өмгөөлөгч	өмгөөлөгчөө	N;VOC;SG
хэлэлцэгч	хэлэлцэгчээ	N;VOC;SG
барьцаа	барьцаагаа	N;VOC;SG
түгжээ	түгжээнээс	N;ABL;SG
боол	боолоос	N;ABL;SG
фокус	фокусаас	N;ABL;SG
түгжрэл	түгжрэлийн	N;GEN;SG
тоормос	тоормосоо	N;VOC;SG
бодрол	бодролоос	N;ABL;SG
барьцаа	барьцаагаар	N;INS;SG
хамсаатан	хамсаатны	N;GEN;SG
гудамж	гудамжийг	N;ACC;SG
зүхэл	зүхлийн	N;GEN;SG
гийгүүлэгч	гийгүүлэгчээ	N;VOC;SG
хэлэлцүүлэг	хэлэлцүүлгээр	N;INS;SG
тэнгис	тэнгисийг	N;ACC;SG
шүүр	шүүрийг	N;ACC;SG
ардчилал	ардчиллаас	N;ABL;SG
хурим	хуримаар	N;INS;SG
атаархал	атаархлын	N;GEN;SG
буудлага	буудлагаа	N;VOC;SG
цамхаг	цамхгаас	N;ABL;SG
балет	балетын	N;GEN;SG
орлогч	орлогчоос	N;ABL;SG
тушаал	тушаалаар	N;INS;SG
эргэлзэл	эргэлзлийг	N;ACC;SG
нислэг	нислэгээс	N;ABL;SG
скаут	скаутаар	N;INS;SG
ажиллах	зулгаав	V;PRF;IND;PRS
ашиглалт	ашиглалтаар	N;INS;SG
утас	утаснаас	N;ABL;SG
аэробик	аэробикийг	N;ACC;SG
ээрүүл	ээрүүлийг	N;ACC;SG
халдлага	халдлагаар	N;INS;SG
шившиг	шившгээр	N;INS;SG
сав	савны	N;GEN;SG
торт	торны	N;GEN;SG
заналхийлэл	заналхийллийн	N;GEN;SG
гадил	гадилаас	N;ABL;SG
хавирга	хавирганы	N;GEN;SG
аммиак	аммиакийн	N;GEN;SG
зорилт	зорилтоо	N;VOC;SG
хэл	хэлний	N;GEN;SG
хүндлэл	хүндлэлийг	N;ACC;SG
урц	урцаар	N;INS;SG
теннис	теннисний	N;GEN;SG
жил	жилийг	N;ACC;SG
дайчин	дайчнаас	N;ABL;SG
оч	очоо	N;VOC;SG
карт	картаа	N;VOC;SG
сүсэгтэн	сүсэгтнээ	N;VOC;SG
тагт	тагтны	N;GEN;SG
тамга	тамгаар	N;INS;SG
гарчиг	гарчгаас	N;ABL;SG
махчин	махчнаа	N;VOC;SG
статистик	статистикаас	N;ABL;SG
хаан	хаанаар	N;INS;SG
бадмаараг	бадмааргаар	N;INS;SG
зөрчилдөөн	зөрчилдөөний	N;GEN;SG
слайд	слайдыг	N;ACC;SG
хүүхэд	хүүхдийг	N;ACC;SG
хайч	хайчаар	N;INS;SG
егөө	егөөний	N;GEN;SG
цуглуулагч	цуглуулагчаар	N;INS;SG
бокс	боксоо	N;VOC;SG
зөрөлдөөн	зөрөлдөөний	N;GEN;SG
бөөм	бөөмийн	N;GEN;SG
хэрэм	хэрмийг	N;ACC;SG
квадрат	квадратаас	N;ABL;SG
тунхаглал	тунхаглалаар	N;INS;SG
болор	болроор	N;INS;SG
цоглог	цоглогоос	N;ABL;SG
хөхрөх	хөхөрчих	V;IMP;SG+PL;2
даамжрал	даамжралын	N;GEN;SG
утаа	утааг	N;ACC;SG
зөрчилдөөн	зөрчилдөөнийг	N;ACC;SG
хорих	хорьсон	V;IND;PST
хүслэн	хүслэнгийн	N;GEN;SG
давталт	давталтын	N;GEN;SG
ноён	ноёноос	N;ABL;SG
анализ	анализын	N;GEN;SG
сэдэгч	сэдэгчийн	N;GEN;SG
үнэлэмж	үнэлэмжийн	N;GEN;SG
даралт	даралтаа	N;VOC;SG
гараг	гаргаас	N;ABL;SG
оргуул	оргуулын	N;GEN;SG
цэр	цэрээр	N;INS;SG
тохируулга	тохируулгаар	N;INS;SG
ялагдал	ялагдлын	N;GEN;SG
тоншуул	тоншуулаас	N;ABL;SG
гэр	гэрээ	N;VOC;SG
зүүд	зүүдээс	N;ABL;SG
сэтгэл	сэтгэлээ	N;VOC;SG
эзлэгч	эзлэгчээр	N;INS;SG
индүүдлэг	индүүдлэгээр	N;INS;SG
бэлхүүс	бэлхүүсийг	N;ACC;SG
хадаас	хадаасаар	N;INS;SG
зүрх	зүрхээ	N;VOC;SG
онгоц	онгоцны	N;GEN;SG
зарц	зарцаа	N;VOC;SG
уриа	уриаг	N;ACC;SG
бяслаг	бяслагаар	N;INS;SG
газар	газраар	N;INS;SG
хамгаалагч	хамгаалагчаар	N;INS;SG
зөвшөөрөл	зөвшөөрлөө	N;VOC;SG
манлайлал	манлайллын	N;GEN;SG
цирк	циркээс	N;ABL;SG
асфальт	асфальтаар	N;INS;SG
кофейн	кофейныг	N;ACC;SG
ахмад	ахмадаас	N;ABL;SG
хувьсал	хувьслаа	N;VOC;SG
тогтвор	тогтвороор	N;INS;SG
барцад	барцдаа	N;VOC;SG
капитализм	капитализмын	N;GEN;SG
биежилт	биежилтээ	N;VOC;SG
цагцгай	цагцгайнаас	N;ABL;SG
амбиц	амбицын	N;GEN;SG
хөндийрөх	хөндийрчих	V;IMP;SG+PL;2
бэрхшээл	бэрхшээлээс	N;ABL;SG
өд	өдөө	N;VOC;SG
тор	торноос	N;ABL;SG
цөхрөл	цөхрөлөө	N;VOC;SG
тайлан	тайлангийн	N;GEN;SG
гүнжид	гүнждээр	N;INS;SG
сүлжээ	сүлжээгээ	N;VOC;SG
дүн	дүнг	N;ACC;SG
сандал	сандлаа	N;VOC;SG
богц	богцоор	N;INS;SG
иш	ишээс	N;ABL;SG
хүдэр	хүдрээр	N;INS;SG
байшин	байшингаа	N;VOC;SG
хууль	хуулиас	N;ABL;SG
тэсрэлт	тэсрэлтийг	N;ACC;SG
өвөл	өвлөөс	N;ABL;SG
доройтол	доройтлыг	N;ACC;SG
тохуу	тохууны	N;GEN;SG
продакшн	продакшны	N;GEN;SG
капитал	капиталаа	N;VOC;SG
шууданч	шууданчаар	N;INS;SG
хадгалалт	хадгалалтын	N;GEN;SG
тактик	тактикаар	N;INS;SG
харьцаа	харьцааны	N;GEN;SG
нийгэм	нийгмийн	N;GEN;SG
ангилал	ангиллын	N;GEN;SG
салаа	салаанаас	N;ABL;SG
илэрхийлэл	илэрхийллээс	N;ABL;SG
эрэг	эргийг	N;ACC;SG
тамга	тамгыг	N;ACC;SG
хэрэм	хэрмийн	N;GEN;SG
өлсгөлөн	өлсгөлөнгийн	N;GEN;SG
зааг	заагаа	N;VOC;SG
тэнгэр	тэнгэрийг	N;ACC;SG
үнэлэлт	үнэлэлтээр	N;INS;SG
тохой	тохойн	N;GEN;SG
жигнэмэг	жигнэмгээ	N;VOC;SG
туйл	туйлыг	N;ACC;SG
тоглогч	тоглогчоор	N;INS;SG
хүүрзгэнэ	хүүрзгэнийн	N;GEN;SG
уулчин	уулчны	N;GEN;SG
сонсох	товойцгоо	V;IMP;PL;2;PRS
огтлолцол	огтлолцлоо	N;VOC;SG
мөчлөг	мөчлөгөөс	N;ABL;SG
өвчин	өвчнөөс	N;ABL;SG
амьтан	амьтнаа	N;VOC;SG
бутрал	бутралаа	N;VOC;SG
найз	найзаар	N;INS;SG
амбаар	амбаарыг	N;ACC;SG
дагалдагч	дагалдагчийн	N;GEN;SG
жигшил	жигшлээс	N;ABL;SG
гацаа	гацаагаа	N;VOC;SG
архи	архийг	N;ACC;SG
шинжлэгч	шинжлэгчээр	N;INS;SG
ээрүүл	ээрүүлээр	N;INS;SG
билет	билетийн	N;GEN;SG
эрмэлзэл	эрмэлзлийн	N;GEN;SG
чичиргээ	чичиргээгээ	N;VOC;SG
эвлэрэх	эвлэрчээ	V;IND;PST
цэвэрлэгээ	цэвэрлэгээнээс	N;ABL;SG
муур	муурын	N;GEN;SG
гар	гараас	N;ABL;SG
анги	ангиас	N;ABL;SG
турник	турникийн	N;GEN;SG
машин	машинаар	N;INS;SG
туршуул	туршуулаа	N;VOC;SG
аймшигтай	аймшгаас	N;ABL;SG
бөгж	бөгжнөөс	N;ABL;SG
яам	яамны	N;GEN;SG
хэмжүүр	хэмжүүрээс	N;ABL;SG
удам	удмаар	N;INS;SG
сэдэв	сэдвээс	N;ABL;SG
тэмцэгч	тэмцэгчийг	N;ACC;SG
үнэр	үнэрээр	N;INS;SG
байлдагч	байлдагчаар	N;INS;SG
линз	линзээр	N;INS;SG
бүтээл	бүтээлээс	N;ABL;SG
мэхлэлт	мэхлэлтээ	N;VOC;SG
тагнуул	тагнуулаа	N;VOC;SG
эвдчих	эвдчээрэй	V;IMP;PL;2;PRS
чихэр	чихрийг	N;ACC;SG
хорсол	хорслоо	N;VOC;SG
гэрэлтүүлэг	гэрэлтүүлгээс	N;ABL;SG
хагарал	хагарлыг	N;ACC;SG
яндан	яндангийн	N;GEN;SG
хадгаламж	хадгаламжаас	N;ABL;SG
шүршигч	шүршигчийг	N;ACC;SG
ололт	ололтоо	N;VOC;SG
хэвшил	хэвшлээс	N;ABL;SG
намтар	намтраас	N;ABL;SG
аюултай	аюулаар	N;INS;SG
суурь	суурийг	N;ACC;SG
ботаник	ботаникаар	N;INS;SG
үйлчлэгч	үйлчлэгчээр	N;INS;SG
гимнастик	гимнастикийн	N;GEN;SG
зууш	зуушаар	N;INS;SG
хөндийрөх	хөндийрцгөө	V;IMP;PL;2;PRS
хэвшил	хэвшлээ	N;VOC;SG
тагт	тагтаар	N;INS;SG
талийгаач	талийгаачаа	N;VOC;SG
пуужин	пуужингийн	N;GEN;SG
мөрөөдөл	мөрөөдлийн	N;GEN;SG
там	тамыг	N;ACC;SG
хөргөгч	хөргөгчийг	N;ACC;SG
чийгшил	чийгшлээ	N;VOC;SG
дээрэм	дээрмээ	N;VOC;SG
нүүрстөрөгч	нүүрстөрөгчөө	N;VOC;SG
үндэс	үндсийг	N;ACC;SG
ойлголт	ойлголтоос	N;ABL;SG
шалгалт	шалгалтыг	N;ACC;SG
өв	өвөө	N;VOC;SG
хагарал	хагарлаа	N;VOC;SG
статистик	статистикийг	N;ACC;SG
чангалуур	чангалуураар	N;INS;SG
эсэргүүцэл	эсэргүүцлээ	N;VOC;SG
казино	казиногоор	N;INS;SG
эмгэнэл	эмгэнэлийн	N;GEN;SG
цэврүү	цэврүүгээ	N;VOC;SG
сүр	сүрээс	N;ABL;SG
үйлдэл	үйлдлийн	N;GEN;SG
чөлөөлөлт	чөлөөлөлтөөс	N;ABL;SG
бөөм	бөөмөө	N;VOC;SG
салалт	салалтын	N;GEN;SG
сүйрэл	сүйрлийн	N;GEN;SG
огторгуй	огторгуйнаас	N;ABL;SG
оргодол	оргодлоос	N;ABL;SG
захиа	захиагаа	N;VOC;SG
биелэлт	биелэлтээ	N;VOC;SG
төлөг	төлөгнөөс	N;ABL;SG
ноорог	нооргоос	N;ABL;SG
тэрслэгч	тэрслэгчээс	N;ABL;SG
сурталчилгааны	сурталчилгааг	N;ACC;SG
сэтгүүл	сэтгүүлийг	N;ACC;SG
исэлдэлт	исэлдэлтээс	N;ABL;SG
драм	драмаа	N;VOC;SG
эдэлгээ	эдэлгээний	N;GEN;SG
хүртвэр	хүртвэрийн	N;GEN;SG
эвдрэл	эвдрэлээр	N;INS;SG
сурталчилгааны	сурталчилгаагаар	N;INS;SG
бөөгнөрөл	бөөгнөрлийг	N;ACC;SG
огтлоос	огтлоосоор	N;INS;SG
ажиллах	зулгаавал	V.CVB;LGSPEC03
халим	халимыг	N;ACC;SG
холестерин	холестерины	N;GEN;SG
хэрэгтэн	хэрэгтнийг	N;ACC;SG
алдагдал	алдагдлаа	N;VOC;SG
өвчтөн	өвчтөнийг	N;ACC;SG
бололцоо	бололцоогоо	N;VOC;SG
ботаник	ботаникаас	N;ABL;SG
багцаа	багцааны	N;GEN;SG
уншигч	уншигчаа	N;VOC;SG
цикл	циклээс	N;ABL;SG
наалт	наалтаа	N;VOC;SG
алхаа	алхаагаар	N;INS;SG
таслалт	таслалтаар	N;INS;SG
ургийнхан	ургаар	N;INS;SG
даажигнал	даажигналаа	N;VOC;SG
ахлагч	ахлагчаас	N;ABL;SG
эвлэрүүлэгч	эвлэрүүлэгчээ	N;VOC;SG
үгүйсгэл	үгүйсгэлийн	N;GEN;SG
хүндрэл	хүндрэлээс	N;ABL;SG
эм	эмээ	N;VOC;SG
шпагетти	шпагеттийг	N;ACC;SG
улангир	улангирын	N;GEN;SG
зарчим	зарчмаар	N;INS;SG
авхуулах	авхуулцгаа	V;IMP;PL;2;PRS
сархад	сархдаас	N;ABL;SG
цэг	цэгийн	N;GEN;SG
тойрог	тойргийн	N;GEN;SG
сэтгүүлч	сэтгүүлчээ	N;VOC;SG
борлуулалт	борлуулалтаа	N;VOC;SG
унжлага	унжлагаа	N;VOC;SG
тарга	таргаа	N;VOC;SG
хөл	хөлөө	N;VOC;SG
эрэг	эргээ	N;VOC;SG
зодоон	зодооноос	N;ABL;SG
бачимдал	бачимдлыг	N;ACC;SG
тэрэг	тэрэгний	N;GEN;SG
чөлөөлөлт	чөлөөлөлтөө	N;VOC;SG
жинлүүр	жинлүүрээ	N;VOC;SG
тоо	тоогоо	N;VOC;SG
алуурчин	алуурчнаар	N;INS;SG
хөдөлгөөн	хөдөлгөөнөө	N;VOC;SG
хүрээ	хүрээг	N;ACC;SG
гадар	гадраа	N;VOC;SG
бөгс	бөгсөө	N;VOC;SG
илгээмж	илгээмжийн	N;GEN;SG
сэрвээ	сэрвээний	N;GEN;SG
тасалбар	тасалбараар	N;INS;SG
зээлдүүлэгч	зээлдүүлэгчийг	N;ACC;SG
үнэлэлт	үнэлэлтийн	N;GEN;SG
сандал	сандлаар	N;INS;SG
хайлш	хайлшаа	N;VOC;SG
нэхэмжлэгч	нэхэмжлэгчээ	N;VOC;SG
хувцас	хувцасны	N;GEN;SG
өт	өтнөөс	N;ABL;SG
сүүдэр	сүүдрийн	N;GEN;SG
сархад	сархдын	N;GEN;SG
зотон	зотонгийн	N;GEN;SG
охин	охиноор	N;INS;SG
зодоон	зодооноор	N;INS;SG
чивчүүр	чивчүүрийг	N;ACC;SG
хязгаарлал	хязгаарлалаас	N;ABL;SG
бөмбөрцөг	бөмбөрцгөө	N;VOC;SG
давхарга	давхаргаас	N;ABL;SG
ололт	ололтыг	N;ACC;SG
горьдлого	горьдлогоо	N;VOC;SG
хандлага	хандлагын	N;GEN;SG
хориглолт	хориглолтоо	N;VOC;SG
зөвшилцөл	зөвшилцлийн	N;GEN;SG
салалт	салалтаар	N;INS;SG
авхуулах	зулгаалаа	V;PRF;IND;PRS
консул	консулыг	N;ACC;SG
модель	моделийн	N;GEN;SG
үймээн	үймээнээ	N;VOC;SG
шүүмж	шүүмжээ	N;VOC;SG
харилцуур	харилцуурыг	N;ACC;SG
шүүгч	шүүгчийг	N;ACC;SG
жор	жорыг	N;ACC;SG
үс	үсээ	N;VOC;SG
шаталт	шаталтаас	N;ABL;SG
нотолгоо	нотолгоог	N;ACC;SG
гайхалтай	гайхлын	N;GEN;SG
ресторан	ресторанаа	N;VOC;SG
цэцэг	цэцгээс	N;ABL;SG
хурим	хуримаа	N;VOC;SG
эрин	эринээс	N;ABL;SG
холгодос	холгодосноос	N;ABL;SG
бариул	бариулаас	N;ABL;SG
нийлбэр	нийлбэрээ	N;VOC;SG
ганцаардал	ганцаардлаар	N;INS;SG
нүдтэй	нүдээр	N;INS;SG
хөдөс	хөдөснөөс	N;ABL;SG
аэробик	аэробикээ	N;VOC;SG
иог	иогоо	N;VOC;SG
үйлчлэгч	үйлчлэгчээ	N;VOC;SG
овор	овроор	N;INS;SG
рационализм	рационализмаас	N;ABL;SG
үүд	үүднээс	N;ABL;SG
зорилт	зорилтоор	N;INS;SG
гудамж	гудамжны	N;GEN;SG
шивэгчин	шивэгчнийг	N;ACC;SG
чангалуур	чангалуурыг	N;ACC;SG
цооног	цооногоо	N;VOC;SG
нийлэмж	нийлэмжээр	N;INS;SG
кино	киног	N;ACC;SG
соруул	соруулаас	N;ABL;SG
зүлэг	зүлгийг	N;ACC;SG
буурцаг	буурцгаа	N;VOC;SG
жүчээ	жүчээний	N;GEN;SG
нуруу	нуруугаар	N;INS;SG
агуулах	агуулахыг	N;ACC;SG
батга	батгыг	N;ACC;SG
сонирхогч	сонирхогчоор	N;INS;SG
бодолт	бодолтын	N;GEN;SG
цахлай	цахлайн	N;GEN;SG
ая	аяыг	N;ACC;SG
уях	уяв	V;PRF;IND;PRS
уншигч	уншигчийн	N;GEN;SG
байшин	байшингийн	N;GEN;SG
бонд	бондоос	N;ABL;SG
итгэл	итгэлийн	N;GEN;SG
жаяг	жаягийг	N;ACC;SG
хувилбар	хувилбарын	N;GEN;SG
эхнэр	эхнэрийг	N;ACC;SG
засвар	засварын	N;GEN;SG
хонх	хонхны	N;GEN;SG
зөрчилдөөн	зөрчилдөөнөөс	N;ABL;SG
сэрэмжлүүлэг	сэрэмжлүүлгийн	N;GEN;SG
эмнэлэг	эмнэлгийг	N;ACC;SG
маяг	маягаа	N;VOC;SG
шүтээн	шүтээнээс	N;ABL;SG
хөдлөл	хөдлөлөөр	N;INS;SG
олборлолт	олборлолтоос	N;ABL;SG
залгамжлал	залгамжлалаа	N;VOC;SG
хурдатгал	хурдатгалын	N;GEN;SG
зээрэнцэг	зээрэнцгийн	N;GEN;SG
мэргэшил	мэргэшлийг	N;ACC;SG
галуу	галуугаа	N;VOC;SG
анхааруулга	анхааруулгын	N;GEN;SG
зүйрлэл	зүйрлэлээс	N;ABL;SG
эслэг	эслэгээр	N;INS;SG
буудал	буудлыг	N;ACC;SG
соёо	соёог	N;ACC;SG
хатуужил	хатуужлыг	N;ACC;SG
лак	лакийн	N;GEN;SG
хамгаалал	хамгааллыг	N;ACC;SG
хаалга	хаалганы	N;GEN;SG
нөөц	нөөцөө	N;VOC;SG
зураглаач	зураглаачаар	N;INS;SG
тэрслэгч	тэрслэгчээр	N;INS;SG
байлдагч	байлдагчийг	N;ACC;SG
ханцуй	ханцуйнаас	N;ABL;SG
хошуу	хошууны	N;GEN;SG
гэргий	гэргийг	N;ACC;SG
сургамж	сургамжаар	N;INS;SG
байнгын	байнгын	N;GEN;SG
залхуурал	залхуурлаас	N;ABL;SG
татвар	татвараас	N;ABL;SG
хөөрөлт	хөөрөлтөөр	N;INS;SG
сэжүүр	сэжүүрээ	N;VOC;SG
хүндэтгэлтэй	хүндэтгэлээс	N;ABL;SG
өндгөвч	өндгөвчөө	N;VOC;SG
хөргүүр	хөргүүрээр	N;INS;SG
программ	программыг	N;ACC;SG
нөөц	нөөцөөр	N;INS;SG
хагацал	хагацлын	N;GEN;SG
зориг	зоригийг	N;ACC;SG
харагдац	харагдцаар	N;INS;SG
сийрэгжих	сийрэгжвэл	V.CVB;LGSPEC03
тэнцвэр	тэнцвэрийг	N;ACC;SG
бонус	бонусыг	N;ACC;SG
агаар	агаараас	N;ABL;SG
түлхүүр	түлхүүрийн	N;GEN;SG
агуй	агуйгаар	N;INS;SG
үнэ	үнийн	N;GEN;SG
хайч	хайчийг	N;ACC;SG
үзэгч	үзэгчийг	N;ACC;SG
үзүүлэн	үзүүлэнгээс	N;ABL;SG
гуя	гуянаас	N;ABL;SG
туурай	туурайгаар	N;INS;SG
магтаал	магтаалыг	N;ACC;SG
хөхрөх	хөхөрцгөө	V;IMP;PL;2;PRS
дух	духаар	N;INS;SG
аммиак	аммиакаас	N;ABL;SG
марк	маркийн	N;GEN;SG
хоосрох	хоосорвол	V.CVB;LGSPEC03
организм	организмоос	N;ABL;SG
дамчин	дамчнаар	N;INS;SG
болзол	болзлын	N;GEN;SG
асфальт	асфальтаас	N;ABL;SG
тотем	тотемоор	N;INS;SG
орчуулга	орчуулгаас	N;ABL;SG
явуулга	явуулгаас	N;ABL;SG
янжуур	янжуурыг	N;ACC;SG
хуяг	хуягаас	N;ABL;SG
гичий	гичийн	N;GEN;SG
шаантаг	шаантгаар	N;INS;SG
дайралт	дайралтаа	N;VOC;SG
даруул	даруулаар	N;INS;SG
анхааруулга	анхааруулгыг	N;ACC;SG
хоншоор	хоншоорыг	N;ACC;SG
тууль	туулийн	N;GEN;SG
ангилалт	ангилалтын	N;GEN;SG
мэдээлэл	мэдээллээ	N;VOC;SG
хувьцаа	хувьцааны	N;GEN;SG
бут	бутнаас	N;ABL;SG
битүүлэг	битүүлгийн	N;GEN;SG
өрц	өрцөө	N;VOC;SG
шүд	шүдээс	N;ABL;SG
гуу	гууг	N;ACC;SG
ойлголт	ойлголтыг	N;ACC;SG
шүүгч	шүүгчээр	N;INS;SG
талийгаач	талийгаачаас	N;ABL;SG
боргио	боргиогоо	N;VOC;SG
энгэсэг	энгэсгийг	N;ACC;SG
өргөлт	өргөлтөө	N;VOC;SG
саун	саунаа	N;VOC;SG
хөгтэй	хөгийг	N;ACC;SG
лазер	лазерыг	N;ACC;SG
цоож	цоожны	N;GEN;SG
байнгын	байнгаас	N;ABL;SG
барилдлага	барилдлагыг	N;ACC;SG
зааварчилгаа	зааварчилгааг	N;ACC;SG
төлөөс	төлөөснөөс	N;ABL;SG
тооцоолол	тооцооллын	N;GEN;SG
уралдаан	уралдаанаас	N;ABL;SG
индукц	индукцээс	N;ABL;SG
байлдагч	байлдагчаас	N;ABL;SG
цөөрөм	цөөрмөө	N;VOC;SG
солиорол	солиорлоо	N;VOC;SG
судлагч	судлагчаас	N;ABL;SG
загасчлал	загасчлалыг	N;ACC;SG
эргэлзэл	эргэлзлийн	N;GEN;SG
сампин	сампинг	N;ACC;SG
тэмдэглэгээ	тэмдэглэгээгээр	N;INS;SG
товойх	товойчих	V;IMP;SG+PL;2
уяа	уяаны	N;GEN;SG
хяналт	хяналтаас	N;ABL;SG
үлгэр	үлгэрээс	N;ABL;SG
эрхэс	эрхсийг	N;ACC;SG
сэдэв	сэдвээ	N;VOC;SG
тонуул	тонуулын	N;GEN;SG
мужаан	мужааны	N;GEN;SG
үнэмшил	үнэмшлээр	N;INS;SG
үеэл	үеэлийг	N;ACC;SG
сэрэмжлүүлэг	сэрэмжлүүлгээ	N;VOC;SG
лимбэдэх	лимбэдвэл	V.CVB;LGSPEC03
бөмбөрцөг	бөмбөрцгийн	N;GEN;SG
багц	багцаас	N;ABL;SG
лектор	лекторын	N;GEN;SG
сорви	сорвиор	N;INS;SG
эзэгнэл	эзэгнэлээс	N;ABL;SG
хөрөнгөтөн	хөрөнгөтний	N;GEN;SG
суман	суманг	N;ACC;SG
хуйвалдаан	хуйвалдаанаар	N;INS;SG
эхлэл	эхлэлийн	N;GEN;SG
жараахай	жараахайг	N;ACC;SG
үргээгч	үргээгчийн	N;GEN;SG
цамхаг	цамхгийн	N;GEN;SG
тунхаглал	тунхаглалаас	N;ABL;SG
бухимдал	бухимдлаар	N;INS;SG
цөмчих	цөмчив	V;PRF;IND;PRS
удиртгал	удиртгалаар	N;INS;SG
хөөх	хөөцгөө	V;IMP;PL;2;PRS
нөлөө	нөлөөнөөс	N;ABL;SG
дуулга	дуулгаа	N;VOC;SG
даруул	даруулаас	N;ABL;SG
ширэг	ширгийг	N;ACC;SG
сав	саваар	N;INS;SG
зүрх	зүрхээр	N;INS;SG
символизм	символизмыг	N;ACC;SG
хувьсал	хувьслын	N;GEN;SG
товчлол	товчлолын	N;GEN;SG
тахиа	тахиаг	N;ACC;SG
дэвүүр	дэвүүрээ	N;VOC;SG
цохиур	цохиураас	N;ABL;SG
дамар	дамраа	N;VOC;SG
жуулчин	жуулчнаас	N;ABL;SG
чөлөөтэй	чөлөөгөө	N;VOC;SG
түвшин	түвшнийг	N;ACC;SG
хайрс	хайрсны	N;GEN;SG
шалгагч	шалгагчаас	N;ABL;SG
гагнуур	гагнуурын	N;GEN;SG
утаа	утаагаа	N;VOC;SG
богц	богцноос	N;ABL;SG
далан	далангаа	N;VOC;SG
дууль	дуулиа	N;VOC;SG
шош	шошоор	N;INS;SG
хуяг	хуягаар	N;INS;SG
бокс	боксоос	N;ABL;SG
ташуур	ташуураас	N;ABL;SG
дагалдагч	дагалдагчаа	N;VOC;SG
нөхөрлөл	нөхөрлөлийн	N;GEN;SG
хүрхрээ	хүрхрээг	N;ACC;SG
завхайрал	завхайрлыг	N;ACC;SG
сүм	сүмээс	N;ABL;SG
мяндас	мяндаснаас	N;ABL;SG
нян	нянгаа	N;VOC;SG
зуршил	зуршлаа	N;VOC;SG
туршлага	туршлагаар	N;INS;SG
овор	оврын	N;GEN;SG
эслэг	эслэгээ	N;VOC;SG
танк	танкаар	N;INS;SG
гаанс	гаансаа	N;VOC;SG
зураглал	зураглалын	N;GEN;SG
чийг	чийгийг	N;ACC;SG
маргаан	маргаанаар	N;INS;SG
аварга	аваргын	N;GEN;SG
урвагч	урвагчаар	N;INS;SG
талийгч	талийгчаа	N;VOC;SG
анги	ангиа	N;VOC;SG
тэвчээр	тэвчээрээр	N;INS;SG
хойг	хойгийг	N;ACC;SG
анхаарал	анхаарлаа	N;VOC;SG
худалдаа	худалдаагаар	N;INS;SG
оптимизм	оптимизмыг	N;ACC;SG
баатар	баатраа	N;VOC;SG
үнэлэмж	үнэлэмжийг	N;ACC;SG
алчуур	алчуураар	N;INS;SG
орой	оройгоо	N;VOC;SG
далайчин	далайчнаас	N;ABL;SG
доргио	доргионы	N;GEN;SG
зурагчин	зурагчнаар	N;INS;SG
ахлагч	ахлагчаа	N;VOC;SG
тэмтрэх	тэмтрэв	V;PRF;IND;PRS
цуглаан	цуглаанаас	N;ABL;SG
санхүү	санхүүг	N;ACC;SG
ухагдахуун	ухагдахуунаа	N;VOC;SG
төсөөлөл	төсөөллийн	N;GEN;SG
амьтай	амиар	N;INS;SG
хөгжим	хөгжмөөр	N;INS;SG
туслалцаа	туслалцааг	N;ACC;SG
тэргүүлэгчид	тэргүүлэгчийн	N;GEN;SG
тор	тороо	N;VOC;SG
шөвхлөх	шөвхөлцгөө	V;IMP;PL;2;PRS
хэмжигч	хэмжигчээ	N;VOC;SG
зураглаач	зураглаачаа	N;VOC;SG
булан	булангийн	N;GEN;SG
үзэгч	үзэгчээс	N;ABL;SG
ходоод	ходоодны	N;GEN;SG
цагдаа	цагдааг	N;ACC;SG
илгээмж	илгээмжээр	N;INS;SG
товчлуур	товчлуураа	N;VOC;SG
сууц	сууцаар	N;INS;SG
оргуул	оргуулыг	N;ACC;SG
нийлэг	нийлгийн	N;GEN;SG
захиалагч	захиалагчаа	N;VOC;SG
эвлэрэх	эвлэрвэл	V.CVB;LGSPEC03
мөргөлчин	мөргөлчний	N;GEN;SG
ялгаруулалт	ялгаруулалтаар	N;INS;SG
байшин	байшинг	N;ACC;SG
зорилго	зорилгоос	N;ABL;SG
захиргаа	захиргаагаа	N;VOC;SG
сонсогч	сонсогчийн	N;GEN;SG
орогнох	орогночих	V;IMP;SG+PL;2
таамаглал	таамаглалын	N;GEN;SG
хүрхрээ	хүрхрээнээс	N;ABL;SG
цооног	цооногийг	N;ACC;SG
үрлэг	үрлэгээр	N;INS;SG
марк	маркаа	N;VOC;SG
ханш	ханшаас	N;ABL;SG
амьтай	амиа	N;VOC;SG
хурд	хурдаа	N;VOC;SG
цэцэрлэг	цэцэрлэгээ	N;VOC;SG
паалан	паалангийн	N;GEN;SG
газар	газраа	N;VOC;SG
түйвээн	түйвээнээ	N;VOC;SG
шинэчлэл	шинэчлэлийн	N;GEN;SG
шөнө	шөнөөр	N;INS;SG
буурь	буурийг	N;ACC;SG
нууц	нууцын	N;GEN;SG
бухимдал	бухимдлын	N;GEN;SG
арал	арлыг	N;ACC;SG
баримт	баримтын	N;GEN;SG
чимхүүр	чимхүүрийг	N;ACC;SG
авхуулах	ажиллавал	V.CVB;LGSPEC03
хуваарь	хуваариа	N;VOC;SG
үйлчилгээ	үйлчилгээний	N;GEN;SG
тасалбар	тасалбарын	N;GEN;SG
хураангуй	хураангуйг	N;ACC;SG
тосгон	тосгоноос	N;ABL;SG
манлайлал	манлайллаа	N;VOC;SG
консул	консулаар	N;INS;SG
ялгалт	ялгалтаас	N;ABL;SG
тоть	тотиноос	N;ABL;SG
баталгаа	баталгаагаар	N;INS;SG
зогсоол	зогсоолоор	N;INS;SG
бүйлс	бүйлсээс	N;ABL;SG
хавцал	хавцлыг	N;ACC;SG
засалт	засалтыг	N;ACC;SG
тоглоом	тоглоомоос	N;ABL;SG
наймаачин	наймаачнаас	N;ABL;SG
ари	арины	N;GEN;SG
үлгэр	үлгэрээр	N;INS;SG
дэр	дэрийг	N;ACC;SG
вирус	вирусийг	N;ACC;SG
авгалдай	авгалдайнаас	N;ABL;SG
гүзээлзгэнэ	гүзээлзгэнийг	N;ACC;SG
анд	андын	N;GEN;SG
долгион	долгионоо	N;VOC;SG
хатгамал	хатгамлыг	N;ACC;SG
төлөг	төлгөө	N;VOC;SG
төлөв	төлөвөөс	N;ABL;SG
ад	адын	N;GEN;SG
хулмас	хулмасаар	N;INS;SG
тэмцэгч	тэмцэгчээр	N;INS;SG
шивнээ	шивнээгээр	N;INS;SG
онош	оношоо	N;VOC;SG
даажигнал	даажигналаар	N;INS;SG
шохой	шохойн	N;GEN;SG
үтрээ	үтрээний	N;GEN;SG
дулаарах	дулаарвал	V.CVB;LGSPEC03
мөнхжих	мөнхөжвөл	V.CVB;LGSPEC03
мэндлэх	мэндэлчих	V;IMP;SG+PL;2
хавцал	хавцлаар	N;INS;SG
аврал	авралаа	N;VOC;SG
ухуулга	ухуулгаар	N;INS;SG
хөдөлмөрчин	хөдөлмөрчнөөс	N;ABL;SG
хакер	хакераас	N;ABL;SG
автомашин	автомашинаа	N;VOC;SG
эсрэгцэл	эсрэгцлээс	N;ABL;SG
багс	багснаас	N;ABL;SG
хадаас	хадааснаас	N;ABL;SG
бөмбөр	бөмбөрөө	N;VOC;SG
нян	нянг	N;ACC;SG
хурандаа	хурандаагаас	N;ABL;SG
билет	билетээр	N;INS;SG
гологдол	гологдлын	N;GEN;SG
аялга	аялгаас	N;ABL;SG
үйлдэл	үйлдлээ	N;VOC;SG
шуугиан	шуугианаа	N;VOC;SG
анчин	анчныг	N;ACC;SG
дэмжлэг	дэмжлэгээр	N;INS;SG
барцад	барцдаас	N;ABL;SG
бүтэлгүйтэл	бүтэлгүйтлээс	N;ABL;SG
нахиа	нахианы	N;GEN;SG
зуршил	зуршлаар	N;INS;SG
чамархай	чамархайг	N;ACC;SG
пүрш	пүршээр	N;INS;SG
завсарлага	завсарлагын	N;GEN;SG
соёо	соёогоо	N;VOC;SG
сахал	сахлаа	N;VOC;SG
ялгаруулалт	ялгаруулалтын	N;GEN;SG
зохиомж	зохиомжоос	N;ABL;SG
моод	моодоор	N;INS;SG
нөхөөс	нөхөөсөөр	N;INS;SG
орогнох	товойвол	V.CVB;LGSPEC03
ололт	ололтоор	N;INS;SG
модель	моделио	N;VOC;SG
хүчилтөрөгч	хүчилтөрөгчөөс	N;ABL;SG
автобус	автобусаа	N;VOC;SG
өрц	өрцний	N;GEN;SG
хэмнэл	хэмнэлээ	N;VOC;SG
хавирга	хавиргыг	N;ACC;SG
мөхөл	мөхлийн	N;GEN;SG
бонд	бондын	N;GEN;SG
эвдрэл	эвдрэлээс	N;ABL;SG
ястан	ястнаа	N;VOC;SG
уншлага	уншлагаар	N;INS;SG
гитар	гитараар	N;INS;SG
дараалал	дарааллыг	N;ACC;SG
уурхайчин	уурхайчнаас	N;ABL;SG
бодрол	бодролын	N;GEN;SG
бульдозер	бульдозероос	N;ABL;SG
сэнс	сэнсний	N;GEN;SG
бамбай	бамбайг	N;ACC;SG
төлөв	төлөвийг	N;ACC;SG
уртраг	уртрагаар	N;INS;SG
гэрлэлт	гэрлэлтээр	N;INS;SG
далай	далайн	N;GEN;SG
чимээ	чимээнээс	N;ABL;SG
довтолгоо	довтолгоог	N;ACC;SG
глюкоз	глюкозоор	N;INS;SG
шүгэл	шүглийг	N;ACC;SG
цөмчих	цөмччих	V;IMP;SG+PL;2
социализм	социализмаа	N;VOC;SG
пайз	пайзны	N;GEN;SG
этгээд	этгээдээр	N;INS;SG
өгүүлэгдэхүүн	өгүүлэгдэхүүнээ	N;VOC;SG
ээж	ээжээр	N;INS;SG
тоншуул	тоншуулын	N;GEN;SG
бөөлжис	бөөлжсийг	N;ACC;SG
эхнэр	эхнэрийн	N;GEN;SG
чадвар	чадвараас	N;ABL;SG
унжлага	унжлагын	N;GEN;SG
нийгэм	нийгмээс	N;ABL;SG
эндэл	эндлийн	N;GEN;SG
устгал	устгалаар	N;INS;SG
хувь	хувиа	N;VOC;SG
дэвшил	дэвшлийг	N;ACC;SG
бэртэлт	бэртэлтийн	N;GEN;SG
эргүүлэг	эргүүлгээс	N;ABL;SG
ангилалт	ангилалтаас	N;ABL;SG
санамж	санамжаар	N;INS;SG
бие	биеийн	N;GEN;SG
солир	солироо	N;VOC;SG
бөөм	бөөмөөр	N;INS;SG
жор	жорын	N;GEN;SG
вальс	вальсыг	N;ACC;SG
мэргэжил	мэргэжлээр	N;INS;SG
тархалт	тархалтын	N;GEN;SG
хэлмэгдэх	хэлмэгдчих	V;IMP;SG+PL;2
зэмлэл	зэмлэлийг	N;ACC;SG
бүтээл	бүтээлээр	N;INS;SG
жүжигчин	жүжигчний	N;GEN;SG
он	оныг	N;ACC;SG
услагч	услагчаас	N;ABL;SG
цирк	циркийн	N;GEN;SG
зөрлөг	зөрлөгөөс	N;ABL;SG
шударга	шударгаар	N;INS;SG
тахих	тахичих	V;IMP;SG+PL;2
хэв	хэвийн	N;GEN;SG
сургууль	сургуулиар	N;INS;SG
уншлага	уншлагыг	N;ACC;SG
туулай	туулайгаа	N;VOC;SG
тавиур	тавиураар	N;INS;SG
судлагч	судлагчаа	N;VOC;SG
заагч	заагчийг	N;ACC;SG
чимэглэл	чимэглэлээ	N;VOC;SG
санаа	санаагаар	N;INS;SG
шүүдэр	шүүдрээ	N;VOC;SG
уйтгар	уйтгараар	N;INS;SG
сүй	сүйг	N;ACC;SG
төгсөгч	төгсөгчөөс	N;ABL;SG
магтаал	магтаалаа	N;VOC;SG
жич	жичээр	N;INS;SG
клуб	клубээс	N;ABL;SG
заль	залиар	N;INS;SG
дэр	дэрээ	N;VOC;SG
өмгөөлөл	өмгөөллөөс	N;ABL;SG
тамирчин	тамирчныг	N;ACC;SG
тууралт	тууралтаа	N;VOC;SG
уйтгартай	уйтгараас	N;ABL;SG
чагт	чагтнаас	N;ABL;SG
халдлага	халдлагаа	N;VOC;SG
гол	голыг	N;ACC;SG
мөгөөрс	мөгөөрсөөр	N;INS;SG
бөмбөр	бөмбөрөөр	N;INS;SG
цээж	цээжний	N;GEN;SG
зугаа	зугаанаас	N;ABL;SG
давтлага	давтлагаас	N;ABL;SG
сэдэгч	сэдэгчээр	N;INS;SG
ил	илээс	N;ABL;SG
чимээ	чимээгээ	N;VOC;SG
манлайлагч	манлайлагчийн	N;GEN;SG
харамсал	харамслаар	N;INS;SG
өчиг	өчгөө	N;VOC;SG
гадуурхал	гадуурхлаар	N;INS;SG
цохио	цохионы	N;GEN;SG
банк	банкийг	N;ACC;SG
алиалагч	алиалагчаа	N;VOC;SG
хувилбар	хувилбараар	N;INS;SG
засалт	засалтаа	N;VOC;SG
ахиц	ахицаар	N;INS;SG
исэг	исгийн	N;GEN;SG
үзүүр	үзүүрийн	N;GEN;SG
эзэн	эзний	N;GEN;SG
угтвар	угтвараар	N;INS;SG
шумуул	шумуулаа	N;VOC;SG
ари	ариар	N;INS;SG
тээрэм	тээрмийн	N;GEN;SG
ресторан	ресторанаар	N;INS;SG
цус	цусаа	N;VOC;SG
хорсол	хорслыг	N;ACC;SG
хэлэлцүүлэг	хэлэлцүүлгийг	N;ACC;SG
солио	солиог	N;ACC;SG
симфони	симфониос	N;ABL;SG
хурдатгал	хурдатгалаас	N;ABL;SG
шатаагч	шатаагчаар	N;INS;SG
мөнх	мөнхийг	N;ACC;SG
арбитр	арбитраас	N;ABL;SG
хатаагуур	хатаагуураас	N;ABL;SG
үүсэл	үүслийг	N;ACC;SG
аюултай	аюулыг	N;ACC;SG
ойлт	ойлтоор	N;INS;SG
түгэх	түгэв	V;PRF;IND;PRS
архичин	архичны	N;GEN;SG
хаалга	хаалгыг	N;ACC;SG
бугуй	бугуйн	N;GEN;SG
гуалин	гуалингаа	N;VOC;SG
хуульч	хуульчаас	N;ABL;SG
шаантаг	шаантгаас	N;ABL;SG
урсгал	урсгалаар	N;INS;SG
хүү	хүүгээс	N;ABL;SG
бут	бутаа	N;VOC;SG
уулзалт	уулзалтаар	N;INS;SG
дэнс	дэнсээс	N;ABL;SG
халаас	халаасыг	N;ACC;SG
үйлчлүүлэгч	үйлчлүүлэгчийг	N;ACC;SG
цавь	цавийг	N;ACC;SG
хадгаламж	хадгаламжийн	N;GEN;SG
эрин	эринээр	N;INS;SG
гох	гохноос	N;ABL;SG
удирдамж	удирдамжаас	N;ABL;SG
гэр	гэрийн	N;GEN;SG
зөвлөл	зөвлөлийн	N;GEN;SG
хотжилт	хотжилтыг	N;ACC;SG
гаанс	гаанснаас	N;ABL;SG
эрдэс	эрдсээс	N;ABL;SG
хольц	хольцоор	N;INS;SG
олс	олсоо	N;VOC;SG
зогсоц	зогсцоо	N;VOC;SG
хэмнэлт	хэмнэлтээр	N;INS;SG
цондон	цондонгоор	N;INS;SG
радио	радиогоор	N;INS;SG
зэвүүцэл	зэвүүцлийн	N;GEN;SG
тэнцэтгэл	тэнцэтгэлээр	N;INS;SG
зүйрлэл	зүйрлэлийн	N;GEN;SG
донтон	донтныг	N;ACC;SG
цэнэглэгч	цэнэглэгчээс	N;ABL;SG
гараг	гаргийг	N;ACC;SG
өнгө	өнгийг	N;ACC;SG
устал	усталаа	N;VOC;SG
ордон	ордноор	N;INS;SG
зөгнөл	зөгнөлөө	N;VOC;SG
бармен	барменээр	N;INS;SG
гогцоо	гогцоогоор	N;INS;SG
цуваа	цуваанаас	N;ABL;SG
тэрслэгч	тэрслэгчийг	N;ACC;SG
дүгнэлт	дүгнэлтээ	N;VOC;SG
ламп	лампнаас	N;ABL;SG
ажиглагч	ажиглагчийн	N;GEN;SG
фермент	ферментээ	N;VOC;SG
төмсөг	төмсгөө	N;VOC;SG
төгсөгч	төгсөгчөө	N;VOC;SG
дүрмийн	дүрмээ	N;VOC;SG
сав	саваа	N;VOC;SG
жүжиг	жүжгээс	N;ABL;SG
багш	багшаас	N;ABL;SG
цохих	цохисон	V;IND;PST
бокс	боксыг	N;ACC;SG
хачирхалтай	хачирхлаас	N;ABL;SG
нэхий	нэхийн	N;GEN;SG
бөмбөрцөг	бөмбөрцгөөс	N;ABL;SG
ялгадас	ялгадсаар	N;INS;SG
сандал	сандлыг	N;ACC;SG
сууц	сууцын	N;GEN;SG
тархалт	тархалтаа	N;VOC;SG
салаа	салааг	N;ACC;SG
код	кодоо	N;VOC;SG
автобус	автобусны	N;GEN;SG
явдал	явдлын	N;GEN;SG
харилцаа	харилцааг	N;ACC;SG
солир	солироос	N;ABL;SG
туршлага	туршлагаа	N;VOC;SG
ламп	лампаар	N;INS;SG
товхимол	товхимлын	N;GEN;SG
суурь	суурийн	N;GEN;SG
тавилга	тавилгаа	N;VOC;SG
амт	амтны	N;GEN;SG
аврагч	аврагчаар	N;INS;SG
туйл	туйлаа	N;VOC;SG
шүүх	шүүхээ	N;VOC;SG
зугаалга	зугаалгын	N;GEN;SG
шингэлт	шингэлтээ	N;VOC;SG
чанар	чанараа	N;VOC;SG
багцаа	багцаанаас	N;ABL;SG
айлчлал	айлчлалын	N;GEN;SG
өчигдөр	өчигдрийн	N;GEN;SG
эгнээ	эгнээгээр	N;INS;SG
цэг	цэгээс	N;ABL;SG
тагт	тагтыг	N;ACC;SG
язгуур	язгуураа	N;VOC;SG
бэлчээр	бэлчээрийн	N;GEN;SG
ашиглалт	ашиглалтын	N;GEN;SG
сампин	сампингаар	N;INS;SG
чагт	чагтаа	N;VOC;SG
дамчин	дамчнаас	N;ABL;SG
захирамж	захирамжийг	N;ACC;SG
ил	илийн	N;GEN;SG
микробиологи	микробиологио	N;VOC;SG
удам	удмаас	N;ABL;SG
аянга	аянгаа	N;VOC;SG
студи	студиэс	N;ABL;SG
засалт	засалтаар	N;INS;SG
ноогдол	ноогдлыг	N;ACC;SG
ерөнхийлөгч	ерөнхийлөгчөөс	N;ABL;SG
таглаа	таглаанаас	N;ABL;SG
цуурай	цуурайн	N;GEN;SG
уйтгартай	уйтгарыг	N;ACC;SG
хүндэтгэл	хүндэтгэлээр	N;INS;SG
нийлүүлэлт	нийлүүлэлтээс	N;ABL;SG
ах	ахаа	N;VOC;SG
шпагетти	шпагеттины	N;GEN;SG
тусламж	тусламжаас	N;ABL;SG
гарц	гарцаа	N;VOC;SG
тохиролцоо	тохиролцоог	N;ACC;SG
хайлт	хайлтаар	N;INS;SG
цуурай	цуурайг	N;ACC;SG
отряд	отрядоо	N;VOC;SG
царцаа	царцаагаар	N;INS;SG
видео	видеог	N;ACC;SG
анхааруулга	анхааруулгаа	N;VOC;SG
сэжигтэн	сэжигтнээр	N;INS;SG
хүнд	хүндээр	N;INS;SG
амраг	амрагаар	N;INS;SG
симфони	симфониор	N;INS;SG
аймшигтай	аймшгийг	N;ACC;SG
харвалт	харвалтаа	N;VOC;SG
цогцолбор	цогцолборыг	N;ACC;SG
өчил	өчлийг	N;ACC;SG
хөвгүүн	хөвгүүнээ	N;VOC;SG
алчуур	алчуураа	N;VOC;SG
эндүүрэл	эндүүрлээ	N;VOC;SG
наалдац	наалдцаас	N;ABL;SG
босуул	босуулаар	N;INS;SG
зэс	зэсээ	N;VOC;SG
хими	химиэр	N;INS;SG
археологи	археологиор	N;INS;SG
онгод	онгодын	N;GEN;SG
компьютер	компьютероос	N;ABL;SG
интернет	интернэтээ	N;VOC;SG
хошууч	хошуучаа	N;VOC;SG
цамц	цамцны	N;GEN;SG
туулай	туулайгаар	N;INS;SG
хийлч	хийлчээр	N;INS;SG
наадам	наадмаар	N;INS;SG
жуулчин	жуулчнаа	N;VOC;SG
ургацаг	ургацгаар	N;INS;SG
анчин	анчнаар	N;INS;SG
хугацаа	хугацааг	N;ACC;SG
тэмцэл	тэмцлээс	N;ABL;SG
ном	номыг	N;ACC;SG
зорилго	зорилгыг	N;ACC;SG
хөгжилтэй	хөгжлөө	N;VOC;SG
хайрс	хайрсаар	N;INS;SG
зөрчигч	зөрчигчөөр	N;INS;SG
хашилт	хашилтын	N;GEN;SG
бухимдал	бухимдлыг	N;ACC;SG
бүйлс	бүйлсийг	N;ACC;SG
хэрэглээ	хэрэглээгээр	N;INS;SG
хошин	хошингийн	N;GEN;SG
төвлөрөл	төвлөрлийн	N;GEN;SG
сөнөөгч	сөнөөгчөөс	N;ABL;SG
зуслан	зуслангийн	N;GEN;SG
ардчилал	ардчиллаа	N;VOC;SG
анхаарал	анхаарлын	N;GEN;SG
ари	ариа	N;VOC;SG
залгаа	залгаагаар	N;INS;SG
чөмөг	чөмөгний	N;GEN;SG
цэнгэл	цэнгэлийг	N;ACC;SG
тулалдаан	тулалдаанаас	N;ABL;SG
хөөрөлт	хөөрөлтөө	N;VOC;SG
конус	конусын	N;GEN;SG
төлөөлөгч	төлөөлөгчөө	N;VOC;SG
ажил	ажлыг	N;ACC;SG
медаль	медалиа	N;VOC;SG
хураангуй	хураангуйн	N;GEN;SG
уянга	уянгаас	N;ABL;SG
ур	ураар	N;INS;SG
зүхэл	зүхлээс	N;ABL;SG
шүүмжлэгч	шүүмжлэгчээс	N;ABL;SG
алхаа	алхааг	N;ACC;SG
бизнес	бизнесийг	N;ACC;SG
хэрчдэс	хэрчдэсийг	N;ACC;SG
хөнгөлөлт	хөнгөлөлтөөр	N;INS;SG
шүүмжлэл	шүүмжлэлээс	N;ABL;SG
төлөгч	төлөгчөөр	N;INS;SG
самуун	самуунаа	N;VOC;SG
шаналгаа	шаналгаагаар	N;INS;SG
ээтийх	авхууллаа	V;PRF;IND;PRS
зэрэг	зэргээс	N;ABL;SG
символизм	символизмын	N;GEN;SG
бүтээлэг	бүтээлгээс	N;ABL;SG
гургуул	гургуулыг	N;ACC;SG
сонсох	товойчих	V;IMP;SG+PL;2
үйлдвэр	үйлдвэрээс	N;ABL;SG
асуулт	асуултаа	N;VOC;SG
мөхөл	мөхлөө	N;VOC;SG
шүлэгч	шүлэгчийг	N;ACC;SG
оновчтой	оновчийн	N;GEN;SG
араншин	араншингаас	N;ABL;SG
зөвшөөрөл	зөвшөөрлийн	N;GEN;SG
шилбэ	шилбийг	N;ACC;SG
багтраа	багтраанаас	N;ABL;SG
үйлчлэл	үйлчлэлээс	N;ABL;SG
гэрэл	гэрлээс	N;ABL;SG
тэвчээр	тэвчээрийг	N;ACC;SG
майонез	майонезыг	N;ACC;SG
цэнэглэгч	цэнэглэгчээр	N;INS;SG
санамж	санамжаас	N;ABL;SG
булчин	булчинг	N;ACC;SG
боол	боолоо	N;VOC;SG
дампуурал	дампуурлыг	N;ACC;SG
хөрш	хөршийг	N;ACC;SG
ваар	ваараас	N;ABL;SG
мэндлэх	мэндэлцгээ	V;IMP;PL;2;PRS
бүтээгдэхүүн	бүтээгдэхүүнээ	N;VOC;SG
эвэрлэг	эвэрлэгийг	N;ACC;SG
хөтөч	хөтчөөс	N;ABL;SG
шүүмж	шүүмжээс	N;ABL;SG
дэнс	дэнсийг	N;ACC;SG
зөвлөгч	зөвлөгчийг	N;ACC;SG
заналхийлэл	заналхийллээс	N;ABL;SG
санаа	санааг	N;ACC;SG
роман	романы	N;GEN;SG
сэнс	сэнсээр	N;INS;SG
боргио	боргионоос	N;ABL;SG
ховс	ховсоор	N;INS;SG
намар	намраар	N;INS;SG
шрифт	шрифтээр	N;INS;SG
бугуй	бугуйг	N;ACC;SG
сануулга	сануулгаар	N;INS;SG
илбэчин	илбэчнээр	N;INS;SG
атираа	атирааны	N;GEN;SG
сургалт	сургалтын	N;GEN;SG
оролдлого	оролдлогоо	N;VOC;SG
цуглуулга	цуглуулгаар	N;INS;SG
майхан	майхнаа	N;VOC;SG
алуурчин	алуурчнаас	N;ABL;SG
хорио	хориогоо	N;VOC;SG
өрц	өрцнөөс	N;ABL;SG
иш	ишээр	N;INS;SG
үйл	үйлээс	N;ABL;SG
гулсуур	гулсуураас	N;ABL;SG
хэц	хэцээ	N;VOC;SG
хүйтэн	хүйтний	N;GEN;SG
хамтрал	хамтралаар	N;INS;SG
цохилт	цохилтоор	N;INS;SG
андгай	андгайгаар	N;INS;SG
үнэлэмж	үнэлэмжээр	N;INS;SG
загатнаа	загатнаагаар	N;INS;SG
эслэг	эслэгээс	N;ABL;SG
ваарчин	ваарчны	N;GEN;SG
хамгаалалт	хамгаалалтаар	N;INS;SG
бүтээл	бүтээлээ	N;VOC;SG
хаяг	хаягаа	N;VOC;SG
дуу	дуугаа	N;VOC;SG
биллиард	биллиардаас	N;ABL;SG
найрлага	найрлагаар	N;INS;SG
хавч	хавчийг	N;ACC;SG
лектор	лектороос	N;ABL;SG
хүүрзгэнэ	хүүрзгэнээр	N;INS;SG
экватор	экваторыг	N;ACC;SG
тосгуур	тосгуураар	N;INS;SG
цөс	цөсөө	N;VOC;SG
савлуур	савлуураар	N;INS;SG
бэх	бэхээ	N;VOC;SG
улс	улсаа	N;VOC;SG
авиа	авианы	N;GEN;SG
албажих	албажив	V;PRF;IND;PRS
ламп	лампны	N;GEN;SG
сонин	сониныг	N;ACC;SG
үүрэг	үүргийг	N;ACC;SG
зам	замаас	N;ABL;SG
сууц	сууцаа	N;VOC;SG
өрсөлдөгч	өрсөлдөгчийг	N;ACC;SG
цөхрөл	цөхрөлийн	N;GEN;SG
бэл	бэлийг	N;ACC;SG
нийлэг	нийлгээс	N;ABL;SG
дун	дунгаас	N;ABL;SG
томилгоо	томилгооноос	N;ABL;SG
далайчин	далайчнаа	N;VOC;SG
нийтлэл	нийтлэлийн	N;GEN;SG
сайд	сайдаа	N;VOC;SG
улирал	улирлаас	N;ABL;SG
өгөөш	өгөөшнөөс	N;ABL;SG
зураглал	зураглалаас	N;ABL;SG
зарц	зарцыг	N;ACC;SG
ханш	ханшаа	N;VOC;SG
вальс	вальсын	N;GEN;SG
бахь	бахины	N;GEN;SG
тохироо	тохирооны	N;GEN;SG
гүн	гүнгийн	N;GEN;SG
хүртвэр	хүртвэрийг	N;ACC;SG
холболт	холболтоор	N;INS;SG
өөрчлөлт	өөрчлөлтийг	N;ACC;SG
эрмэлзэл	эрмэлзлээр	N;INS;SG
уриалга	уриалгаар	N;INS;SG
бэрх	бэрхийг	N;ACC;SG
нөөц	нөөцийн	N;GEN;SG
холбоос	холбоосыг	N;ACC;SG
симфони	симфонийн	N;GEN;SG
видео	видеоноос	N;ABL;SG
цикл	циклээр	N;INS;SG
бизнес	бизнесээр	N;INS;SG
хоолой	хоолойгоос	N;ABL;SG
занга	зангыг	N;ACC;SG
чадвар	чадвараа	N;VOC;SG
ээлж	ээлжээр	N;INS;SG
айдас	айдсыг	N;ACC;SG
бармен	барменийг	N;ACC;SG
үйлдвэрлэгч	үйлдвэрлэгчээс	N;ABL;SG
ноёрхол	ноёрхлын	N;GEN;SG
дагагч	дагагчаа	N;VOC;SG
хэмжигдэхүүн	хэмжигдэхүүнээ	N;VOC;SG
жатга	жатгаас	N;ABL;SG
галлалт	галлалтын	N;GEN;SG
аврагч	аврагчаа	N;VOC;SG
багана	баганаас	N;ABL;SG
найрууламж	найрууламжийн	N;GEN;SG
хиам	хиамыг	N;ACC;SG
генерал	генералаар	N;INS;SG
хандивлагч	хандивлагчаас	N;ABL;SG
хамгаалалт	хамгаалалтаас	N;ABL;SG
хурал	хурлын	N;GEN;SG
казино	казиногийн	N;GEN;SG
паспорт	паспортын	N;GEN;SG
устгагч	устгагчаар	N;INS;SG
загатнаа	загатнаагаа	N;VOC;SG
бөөндөх	бөөндчих	V;IMP;SG+PL;2
архи	архиар	N;INS;SG
зуршил	зуршлыг	N;ACC;SG
иргэн	иргэний	N;GEN;SG
ритм	ритмээр	N;INS;SG
индекс	индексийг	N;ACC;SG
цавь	цавиа	N;VOC;SG
бааз	баазыг	N;ACC;SG
өгзөг	өгзгийг	N;ACC;SG
сойз	сойзоо	N;VOC;SG
төлбөр	төлбөрөөр	N;INS;SG
байгууллага	байгууллагыг	N;ACC;SG
өөрчлөл	өөрчлөлөөр	N;INS;SG
хашаа	хашаагаар	N;INS;SG
хувьсал	хувьслаас	N;ABL;SG
статистик	статистикаар	N;INS;SG
зүг	зүгээ	N;VOC;SG
үхэл	үхлээ	N;VOC;SG
зүүд	зүүдээ	N;VOC;SG
археологи	археологио	N;VOC;SG
авьяастан	авьяастныг	N;ACC;SG
атга	атгаас	N;ABL;SG
молекул	молекулаа	N;VOC;SG
үзэгдэл	үзэгдлээс	N;ABL;SG
шившиг	шившгээ	N;VOC;SG
хөлслөгч	хөлслөгчөөр	N;INS;SG
солонго	солонгоор	N;INS;SG
шилжилт	шилжилтээр	N;INS;SG
гол	голын	N;GEN;SG
хэмжигч	хэмжигчээр	N;INS;SG
гүтгэлэг	гүтгэлгээс	N;ABL;SG
арш	аршийг	N;ACC;SG
турник	турникээр	N;INS;SG
гашуудал	гашуудлын	N;GEN;SG
наалт	наалтаар	N;INS;SG
шатаагч	шатаагчийн	N;GEN;SG
хэмжээс	хэмжээсний	N;GEN;SG
хүүрнэл	хүүрнэлээ	N;VOC;SG
хэрэгжилт	хэрэгжилтийн	N;GEN;SG
хөдөс	хөдсөөр	N;INS;SG
үүл	үүлний	N;GEN;SG
ахиц	ахицыг	N;ACC;SG
зүрхтэй	зүрхээс	N;ABL;SG
үзэгдэл	үзэгдлийн	N;GEN;SG
урамшуулал	урамшууллаас	N;ABL;SG
ялгавар	ялгавраар	N;INS;SG
бариач	бариачаас	N;ABL;SG
шийдвэрлэгч	шийдвэрлэгчийг	N;ACC;SG
бичилт	бичилтээ	N;VOC;SG
зай	зайгаар	N;INS;SG
шүүгээ	шүүгээнээс	N;ABL;SG
илжиг	илжгээ	N;VOC;SG
булингар	булингараар	N;INS;SG
мухлаг	мухлагаа	N;VOC;SG
ойлт	ойлтоо	N;VOC;SG
эзэмшигч	эзэмшигчээр	N;INS;SG
амбаар	амбаараар	N;INS;SG
оргил	оргилоо	N;VOC;SG
машин	машинаас	N;ABL;SG
хөх	хөхийг	N;ACC;SG
найруулагч	найруулагчаас	N;ABL;SG
коммунизм	коммунизмоо	N;VOC;SG
жигшил	жигшлээ	N;VOC;SG
бялуу	бялуунаас	N;ABL;SG
редактор	редактораар	N;INS;SG
арш	аршаар	N;INS;SG
орой	оройгоос	N;ABL;SG
бэсрэг	бэсрэгээ	N;VOC;SG
амьтан	амьтны	N;GEN;SG
өт	өтний	N;GEN;SG
зурхай	зурхайнаас	N;ABL;SG
тэмцэл	тэмцлээ	N;VOC;SG
тогтворжуулалт	тогтворжуулалтаас	N;ABL;SG
хөөх	хөөчих	V;IMP;SG+PL;2
дугуй	дугуйнаас	N;ABL;SG
зөвшилцөл	зөвшилцлөө	N;VOC;SG
тэрэг	тэргийг	N;ACC;SG
голио	голионы	N;GEN;SG
эрэлт	эрэлтээс	N;ABL;SG
гүйцэтгэл	гүйцэтгэлээс	N;ABL;SG
сэжигтэн	сэжигтнээ	N;VOC;SG
өсгөлт	өсгөлтөөр	N;INS;SG
аварга	аваргыг	N;ACC;SG
цэрд	цэрдийн	N;GEN;SG
үргүйдэл	үргүйдлийг	N;ACC;SG
сунгалт	сунгалтаа	N;VOC;SG
турник	турникээ	N;VOC;SG
хүчил	хүчлийг	N;ACC;SG
хэрчдэс	хэрчдэсээс	N;ABL;SG
казино	казиног	N;ACC;SG
төлөвлөгөө	төлөвлөгөөгөөр	N;INS;SG
өөх	өөхийг	N;ACC;SG
хөрөг	хөргөө	N;VOC;SG
түлээчин	түлээчнээ	N;VOC;SG
дагалдагч	дагалдагчаар	N;INS;SG
тахиа	тахианаас	N;ABL;SG
төлөөс	төлөөсийг	N;ACC;SG
соёлжих	соёлжив	V;PRF;IND;PRS
торних	торничих	V;IMP;SG+PL;2
сүлжээ	сүлжээний	N;GEN;SG
найрамдал	найрамдлыг	N;ACC;SG
төвлөрүүлэлт	төвлөрүүлэлтийн	N;GEN;SG
хайрцаг	хайрцгийг	N;ACC;SG
чагт	чагтыг	N;ACC;SG
анчин	анчнаас	N;ABL;SG
санхүү	санхүүгийн	N;GEN;SG
нүдтэй	нүдний	N;GEN;SG
сейф	сейфээс	N;ABL;SG
цэнгүүн	цэнгүүний	N;GEN;SG
үлдэгдэл	үлдэгдлээс	N;ABL;SG
мөчир	мөчрөөр	N;INS;SG
ястан	ястнаар	N;INS;SG
нүүрстөрөгч	нүүрстөрөгчөөс	N;ABL;SG
хувцас	хувцаснаас	N;ABL;SG
мөрдлөг	мөрдлөгийн	N;GEN;SG
далайчин	далайчныг	N;ACC;SG
гадаргуу	гадаргуугаас	N;ABL;SG
дам	дамыг	N;ACC;SG
засалт	засалтаас	N;ABL;SG
талх	талхны	N;GEN;SG
талбар	талбарын	N;GEN;SG
сонирхогч	сонирхогчийн	N;GEN;SG
танк	танкны	N;GEN;SG
аяга	аягыг	N;ACC;SG
үечлэл	үечлэлийг	N;ACC;SG
хаяг	хаягаар	N;INS;SG
төр	төрийг	N;ACC;SG
ханцуй	ханцуйгаар	N;INS;SG
уянга	уянгын	N;GEN;SG
хатуурал	хатуурлаар	N;INS;SG
харуул	харуулаа	N;VOC;SG
сэтгэгдэл	сэтгэгдлийг	N;ACC;SG
тавилга	тавилгаас	N;ABL;SG
тогтворжуулалт	тогтворжуулалтын	N;GEN;SG
ой	ойгоос	N;ABL;SG
луус	луусны	N;GEN;SG
бартаа	бартаанаас	N;ABL;SG
зогсоол	зогсоолоо	N;VOC;SG
хариулт	хариултаа	N;VOC;SG
савхи	савхийг	N;ACC;SG
хучлага	хучлагыг	N;ACC;SG
үнэмшил	үнэмшлийг	N;ACC;SG
хөвөн	хөвөнгөөс	N;ABL;SG
ухуулга	ухуулгаа	N;VOC;SG
хатуулга	хатуулгаас	N;ABL;SG
гох	гохоор	N;INS;SG
шүүмжлэгч	шүүмжлэгчийг	N;ACC;SG
ургийнхан	ургийн	N;GEN;SG
бөмбөр	бөмбөрийг	N;ACC;SG
чөтгөр	чөтгөрөөр	N;INS;SG
эргүү	эргүүгээс	N;ABL;SG
бослого	бослогоор	N;INS;SG
булш	булшийг	N;ACC;SG
жүрж	жүржээ	N;VOC;SG
бясалгал	бясалгалын	N;GEN;SG
оролдлого	оролдлогоос	N;ABL;SG
урлал	урлалаа	N;VOC;SG
удиртгал	удиртгалыг	N;ACC;SG
шарил	шарилаас	N;ABL;SG
гирвэших	ирвэгэнэжээ	V;IND;PST
магтаал	магтаалын	N;GEN;SG
ах	ахаас	N;ABL;SG
гэргий	гэргийгээс	N;ABL;SG
редактор	редакторын	N;GEN;SG
ерөнхийлөгч	ерөнхийлөгчийн	N;GEN;SG
голомт	голомтоос	N;ABL;SG
дамжуулалт	дамжуулалтыг	N;ACC;SG
овог	овгоос	N;ABL;SG
шүүмж	шүүмжийг	N;ACC;SG
зүүд	зүүдээр	N;INS;SG
барьцаа	барьцааны	N;GEN;SG
мэрэгч	мэрэгчийн	N;GEN;SG
цонх	цонхыг	N;ACC;SG
дуудлага	дуудлагаа	N;VOC;SG
там	тамаа	N;VOC;SG
хэл	хэлийг	N;ACC;SG
гадас	гадсаа	N;VOC;SG
яншуй	яншуйг	N;ACC;SG
үймээн	үймээнийг	N;ACC;SG
аялгуу	аялгууны	N;GEN;SG
аймаг	аймгийг	N;ACC;SG
гарц	гарцын	N;GEN;SG
нян	нянгийн	N;GEN;SG
зүхэл	зүхлийг	N;ACC;SG
суралцагч	суралцагчаас	N;ABL;SG
таарамж	таарамжаа	N;VOC;SG
гүүр	гүүрийг	N;ACC;SG
харагдац	харагдцыг	N;ACC;SG
нугас	нугасны	N;GEN;SG
анализ	анализаа	N;VOC;SG
дохио	дохиогоор	N;INS;SG
хэлцэл	хэлцлийн	N;GEN;SG
тэнцвэр	тэнцвэрээр	N;INS;SG
шавар	шаврыг	N;ACC;SG
хаялт	хаялтаар	N;INS;SG
тээвэр	тээврийн	N;GEN;SG
эзэн	эзнээр	N;INS;SG
өмгөөлөл	өмгөөллийн	N;GEN;SG
үе	үеэ	N;VOC;SG
захиалагч	захиалагчаар	N;INS;SG
баясал	баяслыг	N;ACC;SG
дух	духнаас	N;ABL;SG
зурхай	зурхайн	N;GEN;SG
оролдлого	оролдлогын	N;GEN;SG
цэцэглэлт	цэцэглэлтээ	N;VOC;SG
засвар	засвараар	N;INS;SG
дүн	дүнгээ	N;VOC;SG
хувьсгал	хувьсгалыг	N;ACC;SG
цуурга	цуургаа	N;VOC;SG
цайз	цайзаас	N;ABL;SG
жодоо	жодоог	N;ACC;SG
удам	удмыг	N;ACC;SG
шийд	шийдийг	N;ACC;SG
хуудас	хуудасны	N;GEN;SG
батга	батганаас	N;ABL;SG
цонх	цонхноос	N;ABL;SG
хуваарь	хуваарийг	N;ACC;SG
харагдац	харагдцаас	N;ABL;SG
тунхаглал	тунхаглалыг	N;ACC;SG
тохуу	тохуугаа	N;VOC;SG
бамбар	бамбараа	N;VOC;SG
экосистем	экосистемээ	N;VOC;SG
мөрдлөг	мөрдлөгөөс	N;ABL;SG
гаслан	гаслангаар	N;INS;SG
гийчин	гийчнээс	N;ABL;SG
ялагдагч	ялагдагчийн	N;GEN;SG
хадуур	хадуурыг	N;ACC;SG
дулаарах	дулаарчих	V;IMP;SG+PL;2
хараа	хараагаар	N;INS;SG
тогтолцоо	тогтолцоог	N;ACC;SG
хориглолт	хориглолтоор	N;INS;SG
бүсгүй	бүсгүйгээ	N;VOC;SG
бэр	бэрээр	N;INS;SG
туурай	туурайгаа	N;VOC;SG
яншуй	яншуйнаас	N;ABL;SG
шүүмж	шүүмжээр	N;INS;SG
янз	янзыг	N;ACC;SG
горим	горимоор	N;INS;SG
халамж	халамжаар	N;INS;SG
цөхрөл	цөхрөлөөс	N;ABL;SG
холбоо	холбооноос	N;ABL;SG
дугуй	дугуйгаа	N;VOC;SG
шүршигч	шүршигчээр	N;INS;SG
бие	биеэ	N;VOC;SG
шийр	шийрийн	N;GEN;SG
им	имээ	N;VOC;SG
дээрэм	дээрмээр	N;INS;SG
хавцал	хавцлаас	N;ABL;SG
эмч	эмчээр	N;INS;SG
татвар	татварын	N;GEN;SG
яндан	яндангаар	N;INS;SG
буга	бугаа	N;VOC;SG
индүүдлэг	индүүдлэгийг	N;ACC;SG
мэндлэх	мэндэлжээ	V;IND;PST
төлөв	төлөвийн	N;GEN;SG
томьёо	томьёог	N;ACC;SG
тэмүүлэл	тэмүүллийг	N;ACC;SG
үзэгч	үзэгчийн	N;GEN;SG
чагт	чагтаар	N;INS;SG
гинж	гинжээр	N;INS;SG
хавар	хавраар	N;INS;SG
дархлаа	дархлааг	N;ACC;SG
гайхамшиг	гайхамшгийн	N;GEN;SG
жуулчин	жуулчны	N;GEN;SG
зай	зайнаас	N;ABL;SG
чиргүүл	чиргүүлээ	N;VOC;SG
цөм	цөмөө	N;VOC;SG
бичээс	бичээсээс	N;ABL;SG
ашигтай	ашгийг	N;ACC;SG
шумуул	шумуулаас	N;ABL;SG
бүжигчин	бүжигчний	N;GEN;SG
луйвар	луйврыг	N;ACC;SG
бөгж	бөгжөөр	N;INS;SG
биелэлт	биелэлтээс	N;ABL;SG
хашаа	хашаагаа	N;VOC;SG
хөдөлмөрчин	хөдөлмөрчнийг	N;ACC;SG
инженер	инженерээр	N;INS;SG
дараалал	дарааллын	N;GEN;SG
сүүдрэвч	сүүдрэвчийг	N;ACC;SG
кино	киногоо	N;VOC;SG
тах	тахаа	N;VOC;SG
хандлага	хандлагаар	N;INS;SG
цэврүү	цэврүүгээр	N;INS;SG
хоног	хоногоор	N;INS;SG
символизм	символизмоор	N;INS;SG
судлаач	судлаачийн	N;GEN;SG
хэвлий	хэвлийг	N;ACC;SG
тамга	тамгаа	N;VOC;SG
номлол	номлолоор	N;INS;SG
аавынх	ааваас	N;ABL;SG
бүтээлэг	бүтээлгийн	N;GEN;SG
гөрөө	гөрөөгөө	N;VOC;SG
мануухай	мануухайг	N;ACC;SG
үрчлээ	үрчлээний	N;GEN;SG
зохицуулалт	зохицуулалтаас	N;ABL;SG
дэл	дэлээр	N;INS;SG
цом	цомоор	N;INS;SG
шүд	шүдээ	N;VOC;SG
сэжүүр	сэжүүрийн	N;GEN;SG
мэхлэгч	мэхлэгчийг	N;ACC;SG
бээлий	бээлийгээ	N;VOC;SG
урилга	урилгаас	N;ABL;SG
хучилт	хучилтаас	N;ABL;SG
өчигдөр	өчигдрийг	N;ACC;SG
диваажин	диваажингаа	N;VOC;SG
тунадас	тунадсаар	N;INS;SG
бэр	бэрийг	N;ACC;SG
зураглаач	зураглаачаас	N;ABL;SG
эвтэй	эвийг	N;ACC;SG
сөргөлдөөн	сөргөлдөөнийг	N;ACC;SG
захиргаа	захиргаанаас	N;ABL;SG
хөөрөлт	хөөрөлтийн	N;GEN;SG
тохь	тохиос	N;ABL;SG
тэнцэтгэл	тэнцэтгэлийг	N;ACC;SG
төлөвлөгөө	төлөвлөгөөг	N;ACC;SG
дагагч	дагагчаар	N;INS;SG
алга	алганаас	N;ABL;SG
шумуул	шумуулаар	N;INS;SG
хөл	хөлийг	N;ACC;SG
фракц	фракцын	N;GEN;SG
бөмбөг	бөмбөгөөр	N;INS;SG
уулзвар	уулзварыг	N;ACC;SG
сал	салаа	N;VOC;SG
хандив	хандивын	N;GEN;SG
томуу	томууг	N;ACC;SG
ирвэгэнэх	хэлмэгдвэл	V.CVB;LGSPEC03
цөс	цөсийг	N;ACC;SG
угаалтуур	угаалтуурыг	N;ACC;SG
хязгаарлалт	хязгаарлалтаа	N;VOC;SG
зарлага	зарлагаар	N;INS;SG
ололт	ололтоос	N;ABL;SG
хайлш	хайлшнаас	N;ABL;SG
оёдолчин	оёдолчны	N;GEN;SG
гавьяа	гавьяаны	N;GEN;SG
гялтгануур	гялтгануураа	N;VOC;SG
хөлөг	хөлгөөр	N;INS;SG
амталгаа	амталгааг	N;ACC;SG
санаачлагч	санаачлагчийн	N;GEN;SG
өв	өвийг	N;ACC;SG
жил	жилийн	N;GEN;SG
хүнд	хүндийг	N;ACC;SG
урвал	урвалаас	N;ABL;SG
тохиргоо	тохиргоогоор	N;INS;SG
алхам	алхмаар	N;INS;SG
хаялт	хаялтаа	N;VOC;SG
жич	жичийн	N;GEN;SG
өгөөжтэй	өгөөжөө	N;VOC;SG
дарангуйлагч	дарангуйлагчаас	N;ABL;SG
дэлгэц	дэлгэцээс	N;ABL;SG
улангир	улангирыг	N;ACC;SG
дэлбэрэлт	дэлбэрэлтээр	N;INS;SG
турник	турникийг	N;ACC;SG
уул	уулаас	N;ABL;SG
захиа	захианаас	N;ABL;SG
хичээл	хичээлээр	N;INS;SG
овог	овгийг	N;ACC;SG
зөрчил	зөрчлөөр	N;INS;SG
ойлт	ойлтоос	N;ABL;SG
шаантаг	шаантгийг	N;ACC;SG
тоншуул	тоншуулаар	N;INS;SG
үсрэлт	үсрэлтийн	N;GEN;SG
наймаа	наймааг	N;ACC;SG
үсэглэл	үсэглэлээс	N;ABL;SG
бослого	бослогоо	N;VOC;SG
масштаб	масштабаа	N;VOC;SG
карантин	карантиныг	N;ACC;SG
баталгаа	баталгааны	N;GEN;SG
лаа	лаагаар	N;INS;SG
илбэчин	илбэчнээс	N;ABL;SG
утас	утасны	N;GEN;SG
ёзоор	ёзоороор	N;INS;SG
хамтрал	хамтралаас	N;ABL;SG
найруулга	найруулгыг	N;ACC;SG
бүрэлбаа	бүрэлбааг	N;ACC;SG
зэс	зэсийн	N;GEN;SG
ташуур	ташуурын	N;GEN;SG
завсарлага	завсарлагыг	N;ACC;SG
шинжилгээ	шинжилгээнээс	N;ABL;SG
дүгнэлт	дүгнэлтийн	N;GEN;SG
дайн	дайныг	N;ACC;SG
шан	шангаар	N;INS;SG
заавар	зааврыг	N;ACC;SG
чичиргээ	чичиргээг	N;ACC;SG
кофейн	кофейноос	N;ABL;SG
магадлал	магадлалаа	N;VOC;SG
багаж	багажийг	N;ACC;SG
хөрөнгөтөн	хөрөнгөтнөөс	N;ABL;SG
гурил	гурилаар	N;INS;SG
эрхлэгч	эрхлэгчээ	N;VOC;SG
хясаа	хясааг	N;ACC;SG
амталгаа	амталгааны	N;GEN;SG
эргэцүүлэл	эргэцүүллийг	N;ACC;SG
таглаа	таглааг	N;ACC;SG
бүтэлгүйтэл	бүтэлгүйтлийн	N;GEN;SG
уриалга	уриалгаас	N;ABL;SG
эдэлгээ	эдэлгээгээ	N;VOC;SG
тойрог	тойргоос	N;ABL;SG
захидал	захидлын	N;GEN;SG
мандолин	мандолинаар	N;INS;SG
өчигдөр	өчигдрөө	N;VOC;SG
анхааруулга	анхааруулгаар	N;INS;SG
мэхлэлт	мэхлэлтийн	N;GEN;SG
журам	журмын	N;GEN;SG
хамар	хамрын	N;GEN;SG
сүрдүүлэг	сүрдүүлгийн	N;GEN;SG
өчил	өчлөөс	N;ABL;SG
өрсөлдөөн	өрсөлдөөнийг	N;ACC;SG
шуудай	шуудайнаас	N;ABL;SG
эвдчих	эвдэччих	V;IMP;SG+PL;2
оромж	оромжийг	N;ACC;SG
шархлаа	шархлаагаар	N;INS;SG
ойлголт	ойлголтоо	N;VOC;SG
бөгс	бөгснөөс	N;ABL;SG
текст	текстээс	N;ABL;SG
сүсэгтэн	сүсэгтний	N;GEN;SG
цардас	цардасны	N;GEN;SG
оосор	оосрыг	N;ACC;SG
өвдөг	өвдөгний	N;GEN;SG
тусгал	тусгалаар	N;INS;SG
шүүрэл	шүүрлээр	N;INS;SG
хохирол	хохирлын	N;GEN;SG
цилиндр	цилиндрээ	N;VOC;SG
хамтатгал	хамтатгалаа	N;VOC;SG
шүхэр	шүхрээ	N;VOC;SG
сампин	сампингаа	N;VOC;SG
алт	алтны	N;GEN;SG
тагтаа	тагтаанаас	N;ABL;SG
мэндчилгээ	мэндчилгээг	N;ACC;SG
сурталчилгааны	сурталчилгааны	N;GEN;SG
зуслан	зуслангаас	N;ABL;SG
даяанч	даяанчийг	N;ACC;SG
байгаль	байгалиас	N;ABL;SG
банз	банзаар	N;INS;SG
далай	далайнаас	N;ABL;SG
огтлоос	огтлоосноос	N;ABL;SG
хураангуй	хураангуйгаа	N;VOC;SG
ястан	ястныг	N;ACC;SG
тохуурхал	тохуурхлыг	N;ACC;SG
урагшлах	урагшилцгаа	V;IMP;PL;2;PRS
заль	залиа	N;VOC;SG
саа	сааг	N;ACC;SG
мөрдөгч	мөрдөгчөө	N;VOC;SG
хөлс	хөлснөөс	N;ABL;SG
сэргээш	сэргээшээр	N;INS;SG
мэдэгдэл	мэдэгдлээ	N;VOC;SG
худалдагч	худалдагчаас	N;ABL;SG
хайлт	хайлтаа	N;VOC;SG
тушаал	тушаалыг	N;ACC;SG
этгээд	этгээдээ	N;VOC;SG
засалт	засалтын	N;GEN;SG
экологи	экологиор	N;INS;SG
этгээд	этгээдийн	N;GEN;SG
шийдвэрлэгч	шийдвэрлэгчээс	N;ABL;SG
тасрал	тасралаар	N;INS;SG
зулай	зулайгаа	N;VOC;SG
ичээ	ичээнээс	N;ABL;SG
гүүр	гүүрний	N;GEN;SG
шүлсэвч	шүлсэвчээ	N;VOC;SG
андгай	андгайг	N;ACC;SG
жүчээ	жүчээг	N;ACC;SG
хадгаламж	хадгаламжийг	N;ACC;SG
хөнгөлөлт	хөнгөлөлтийн	N;GEN;SG
байлдаан	байлдааныг	N;ACC;SG
өөрчлөлт	өөрчлөлтөө	N;VOC;SG
дуулаач	дуулаачийг	N;ACC;SG
сорох	сорвол	V.CVB;LGSPEC03
шүүгч	шүүгчийн	N;GEN;SG
найдлага	найдлагаар	N;INS;SG
стратеги	стратегийг	N;ACC;SG
төгсгөл	төгсгөлөөр	N;INS;SG
тооцоо	тооцоогоо	N;VOC;SG
бөндгөр	бөндгөрөөр	N;INS;SG
чангалуур	чангалуураас	N;ABL;SG
гуалин	гуалингаар	N;INS;SG
анд	андаа	N;VOC;SG
дутагдал	дутагдлаа	N;VOC;SG
байшин	байшингаар	N;INS;SG
зуучлагч	зуучлагчаас	N;ABL;SG
хийсвэрлэл	хийсвэрлэлээ	N;VOC;SG
хамтрагч	хамтрагчаар	N;INS;SG
намтар	намтраар	N;INS;SG
солбицох	солбицсон	V;IND;PST
сайжруулалт	сайжруулалтаар	N;INS;SG
шилжилт	шилжилтийн	N;GEN;SG
хүү	хүүг	N;ACC;SG
сэрвээ	сэрвээнээс	N;ABL;SG
хугарал	хугарлыг	N;ACC;SG
шуурга	шуургыг	N;ACC;SG
харьцуулал	харьцууллын	N;GEN;SG
конус	конусаас	N;ABL;SG
касс	кассыг	N;ACC;SG
саад	саадаас	N;ABL;SG
гялтгануур	гялтгануурын	N;GEN;SG
уураг	уургаа	N;VOC;SG
гуу	гуугаар	N;INS;SG
арьс	арьсыг	N;ACC;SG
нөхвөр	нөхвөрөө	N;VOC;SG
яриа	ярианаас	N;ABL;SG
өргөлт	өргөлтийн	N;GEN;SG
зохиомж	зохиомжийн	N;GEN;SG
зөн	зөнгөө	N;VOC;SG
цахлай	цахлайгаа	N;VOC;SG
мэдээ	мэдээний	N;GEN;SG
нууцлал	нууцлалаар	N;INS;SG
зурлага	зурлагыг	N;ACC;SG
банзал	банзлын	N;GEN;SG
төвлөрөл	төвлөрлөөр	N;INS;SG
лимбэдэх	лимбэдэв	V;PRF;IND;PRS
чиг	чигээс	N;ABL;SG
хөөрөл	хөөрлөөс	N;ABL;SG
сувд	сувдыг	N;ACC;SG
судлагч	судлагчийг	N;ACC;SG
зүлгүүр	зүлгүүрээ	N;VOC;SG
лазер	лазерын	N;GEN;SG
өсгий	өсгийнөөс	N;ABL;SG
бахиудах	бахиудсан	V;IND;PST
хаяг	хаягийн	N;GEN;SG
сунгалт	сунгалтаас	N;ABL;SG
агуулах	агуулахаар	N;INS;SG
хотжих	хотожсон	V;IND;PST
хана	ханаа	N;VOC;SG
коммунизм	коммунизмоос	N;ABL;SG
булчин	булчингийн	N;GEN;SG
харилцуур	харилцуураар	N;INS;SG
ялагч	ялагчийн	N;GEN;SG
дурсамж	дурсамжаар	N;INS;SG
түлээчин	түлээчнээс	N;ABL;SG
материализм	материализмыг	N;ACC;SG
ах	ахаар	N;INS;SG
холгодос	холгодосны	N;GEN;SG
сонин	сониноос	N;ABL;SG
гүзээлзгэнэ	гүзээлзгэнээ	N;VOC;SG
маажин	маажингийн	N;GEN;SG
эцэг	эцгээр	N;INS;SG
амь	амийг	N;ACC;SG
студи	студийг	N;ACC;SG
нохой	нохойгоор	N;INS;SG
зөвлөгөө	зөвлөгөөг	N;ACC;SG
лавлагаа	лавлагаанаас	N;ABL;SG
ёгтлол	ёгтлолоо	N;VOC;SG
өрөмдлөг	өрөмдлөгөөр	N;INS;SG
хардалт	хардалтаа	N;VOC;SG
авхуулах	зулгаасан	V;IND;PST
хэрүүл	хэрүүлийг	N;ACC;SG
адгуус	адгуусаар	N;INS;SG
нэмэгдэл	нэмэгдлийг	N;ACC;SG
хөндийрөх	хөндийрөв	V;PRF;IND;PRS
саа	сааны	N;GEN;SG
харвалт	харвалтыг	N;ACC;SG
сэтгүүлч	сэтгүүлчийн	N;GEN;SG
зээл	зээлээр	N;INS;SG
найрлага	найрлагыг	N;ACC;SG
торт	тороо	N;VOC;SG
илэрхийлэл	илэрхийллийг	N;ACC;SG
луужин	луужингаа	N;VOC;SG
өв	өвийн	N;GEN;SG
зэвүүцэл	зэвүүцлээр	N;INS;SG
тагтаа	тагтаагаа	N;VOC;SG
хийл	хийлээс	N;ABL;SG
бармен	барменээс	N;ABL;SG
зугаалга	зугаалгаар	N;INS;SG
холбоо	холбооны	N;GEN;SG
түнш	түншээ	N;VOC;SG
мэтгэлцэгч	мэтгэлцэгчээр	N;INS;SG
нүүдэл	нүүдлийн	N;GEN;SG
шан	шангаа	N;VOC;SG
ирвэгэнэх	хэлмэгдэв	V;PRF;IND;PRS
чагнаал	чагнаалыг	N;ACC;SG
хэрсүү	хэрсүүг	N;ACC;SG
гургуул	гургуулаа	N;VOC;SG
дэлгүүр	дэлгүүрээ	N;VOC;SG
фронт	фронтоо	N;VOC;SG
ул	улыг	N;ACC;SG
байгууламж	байгууламжаар	N;INS;SG
нөмрөг	нөмрөгөө	N;VOC;SG
ваар	ваарыг	N;ACC;SG
дусал	дуслын	N;GEN;SG
арифметик	арифметикаас	N;ABL;SG
мэдээлэл	мэдээллээс	N;ABL;SG
ээрүүл	ээрүүлээс	N;ABL;SG
шинж	шинжээр	N;INS;SG
завхайрал	завхайрлаар	N;INS;SG
хошууч	хошуучаар	N;INS;SG
теннис	теннисээ	N;VOC;SG
дэн	дэнгийн	N;GEN;SG
студи	студийн	N;GEN;SG
эрэлт	эрэлтийн	N;GEN;SG
тоглолт	тоглолтоос	N;ABL;SG
зүйрлэл	зүйрлэлийг	N;ACC;SG
сэтгүүлч	сэтгүүлчийг	N;ACC;SG
тугалга	тугалганаас	N;ABL;SG
урвагч	урвагчийг	N;ACC;SG
ач	ачаас	N;ABL;SG
наалдац	наалдцыг	N;ACC;SG
өр	өрийг	N;ACC;SG
шарх	шархаа	N;VOC;SG
далдлалт	далдлалтын	N;GEN;SG
шүүрэл	шүүрлээс	N;ABL;SG
бохирдол	бохирдлоо	N;VOC;SG
тамирчин	тамирчны	N;GEN;SG
бэх	бэхээс	N;ABL;SG
хун	хунгаар	N;INS;SG
сэлэм	сэлмийг	N;ACC;SG
цааз	цаазыг	N;ACC;SG
төлөөлөгч	төлөөлөгчөөс	N;ABL;SG
үргэлжлэл	үргэлжлэлийн	N;GEN;SG
багтраа	багтрааг	N;ACC;SG
бүлэглэл	бүлэглэлээ	N;VOC;SG
овоолох	орогновол	V.CVB;LGSPEC03
цөхрөл	цөхрөлийг	N;ACC;SG
шүршүүр	шүршүүрээ	N;VOC;SG
шимтгэл	шимтгэлээр	N;INS;SG
будаа	будааны	N;GEN;SG
бээлий	бээлийг	N;ACC;SG
соруул	соруулыг	N;ACC;SG
оёдол	оёдлоос	N;ABL;SG
харьцуулалт	харьцуулалтын	N;GEN;SG
тэврэлт	тэврэлтийн	N;GEN;SG
ажиллах	ажиллацгаа	V;IMP;PL;2;PRS
бүтээлэг	бүтээлгийг	N;ACC;SG
нөөц	нөөцийг	N;ACC;SG
ертөнц	ертөнцөө	N;VOC;SG
үргүйдэл	үргүйдлийн	N;GEN;SG
хатуужил	хатуужлаас	N;ABL;SG
нягтрал	нягтралаас	N;ABL;SG
лазер	лазераар	N;INS;SG
мэргэшил	мэргэшлийн	N;GEN;SG
байдал	байдлыг	N;ACC;SG
зорчигч	зорчигчоос	N;ABL;SG
тариур	тариураар	N;INS;SG
тамхичин	тамхичнаа	N;VOC;SG
бонус	бонусын	N;GEN;SG
горим	горимын	N;GEN;SG
тэмтрүүл	тэмтрүүлээр	N;INS;SG
дуализм	дуализмыг	N;ACC;SG
паспорт	паспортыг	N;ACC;SG
зэс	зэсээс	N;ABL;SG
ажиллагаа	ажиллагаанаас	N;ABL;SG
харьцуулалт	харьцуулалтаар	N;INS;SG
аваар	аваараа	N;VOC;SG
саун	саунаар	N;INS;SG
урлаг	урлагаас	N;ABL;SG
угтвар	угтвараас	N;ABL;SG
өөрчлөгч	өөрчлөгчийг	N;ACC;SG
мансуурал	мансуурлын	N;GEN;SG
аэробик	аэробикээр	N;INS;SG
жимс	жимсний	N;GEN;SG
урхи	урхиар	N;INS;SG
үг	үгээ	N;VOC;SG
зарчим	зарчмыг	N;ACC;SG
эцэс	эцсээс	N;ABL;SG
боловсрол	боловсролоос	N;ABL;SG
акт	актаар	N;INS;SG
гуйлт	гуйлтаар	N;INS;SG
зугаа	зугаагаа	N;VOC;SG
эзэн	эзнийг	N;ACC;SG
банз	банзны	N;GEN;SG
жигнэмэг	жигнэмгийн	N;GEN;SG
барих	барьсан	V;IND;PST
азот	азотоос	N;ABL;SG
банз	банзнаас	N;ABL;SG
түлээчин	түлээчнээр	N;INS;SG
зүг	зүгийн	N;GEN;SG
эх	эхээ	N;VOC;SG
цорго	цоргоо	N;VOC;SG
хуанли	хуанлиар	N;INS;SG
зуучлагч	зуучлагчийн	N;GEN;SG
шүр	шүрээ	N;VOC;SG
идэгдэл	идэгдлээр	N;INS;SG
хугарал	хугарлаар	N;INS;SG
цикл	циклийг	N;ACC;SG
глюкоз	глюкозыг	N;ACC;SG
даяарших	даяаршицгаа	V;IMP;PL;2;PRS
амбиц	амбицаас	N;ABL;SG
амьжиргаа	амьжиргааны	N;GEN;SG
үүд	үүдээ	N;VOC;SG
залгамжлал	залгамжлалаар	N;INS;SG
гажиг	гажгаас	N;ABL;SG
теннис	теннисийг	N;ACC;SG
заагч	заагчаар	N;INS;SG
саатал	саатлын	N;GEN;SG
барих	баривал	V.CVB;LGSPEC03
хүндрэл	хүндрэлээ	N;VOC;SG
тавилан	тавилангаар	N;INS;SG
өмгөөлөгч	өмгөөлөгчөөс	N;ABL;SG
маргаан	маргаанаа	N;VOC;SG
танго	тангог	N;ACC;SG
мөрдөс	мөрдөснөөс	N;ABL;SG
дайчилгаа	дайчилгаанаас	N;ABL;SG
зам	замаар	N;INS;SG
линз	линзийг	N;ACC;SG
хувьсал	хувьслыг	N;ACC;SG
аялга	аялгаар	N;INS;SG
урвагч	урвагчийн	N;GEN;SG
угж	угжаар	N;INS;SG
алдартан	алдартныг	N;ACC;SG
үнэлэмж	үнэлэмжээ	N;VOC;SG
сүрэг	сүргээ	N;VOC;SG
тактик	тактикаа	N;VOC;SG
эрэмбэ	эрэмбээс	N;ABL;SG
зурхай	зурхайг	N;ACC;SG
өвчин	өвчнийг	N;ACC;SG
шүүмжлэл	шүүмжлэлийн	N;GEN;SG
дээс	дээсийг	N;ACC;SG
үйлдэл	үйлдлээс	N;ABL;SG
горхи	горхийг	N;ACC;SG
сонсогч	сонсогчоор	N;INS;SG
харьцуулал	харьцууллаар	N;INS;SG
цахлай	цахлайг	N;ACC;SG
архичин	архичныг	N;ACC;SG
егөөдөл	егөөдлөөр	N;INS;SG
орогнох	орогнов	V;PRF;IND;PRS
дүрэм	дүрмийг	N;ACC;SG
орчуулга	орчуулгаа	N;VOC;SG
эвлэрүүлэгч	эвлэрүүлэгчээр	N;INS;SG
цахирмаа	цахирмааг	N;ACC;SG
төгсөгч	төгсөгчийн	N;GEN;SG
хорхой	хорхойгоо	N;VOC;SG
өчигдөр	өчигдрөөр	N;INS;SG
баясал	баяслаа	N;VOC;SG
молекул	молекулын	N;GEN;SG
дахилт	дахилтыг	N;ACC;SG
бөөндөх	бөөндсөн	V;IND;PST
үзлэг	үзлэгээ	N;VOC;SG
эвлэрэх	эвлэрчих	V;IMP;SG+PL;2
авиа	авиагаар	N;INS;SG
сүрдүүлэг	сүрдүүлгээр	N;INS;SG
жатга	жатгыг	N;ACC;SG
халбага	халбагыг	N;ACC;SG
гаргалт	гаргалтаас	N;ABL;SG
бизнес	бизнесээс	N;ABL;SG
хилэгнэл	хилэгнэлийн	N;GEN;SG
анкет	анкетаас	N;ABL;SG
сунгалт	сунгалтыг	N;ACC;SG
найз	найзыг	N;ACC;SG
хамгаалал	хамгааллаа	N;VOC;SG
хэлэхүй	хэлэхүйгээр	N;INS;SG
дэл	дэлийг	N;ACC;SG
пүрш	пүршээ	N;VOC;SG
ус	усыг	N;ACC;SG
бүрэлбаа	бүрэлбааны	N;GEN;SG
асуудал	асуудлын	N;GEN;SG
роман	романаас	N;ABL;SG
доллар	долларыг	N;ACC;SG
хүчтэй	хүчний	N;GEN;SG
суваг	сувгийг	N;ACC;SG
уриа	урианаас	N;ABL;SG
бижрүү	бижрүүнээс	N;ABL;SG
байгаль	байгалиа	N;VOC;SG
адар	адраа	N;VOC;SG
хэлэлцэгч	хэлэлцэгчийн	N;GEN;SG
судлаач	судлаачийг	N;ACC;SG
зорчигч	зорчигчоор	N;INS;SG
суман	сумангаа	N;VOC;SG
солбицох	солбицчих	V;IMP;SG+PL;2
тулаан	тулаанаар	N;INS;SG
хаан	хааны	N;GEN;SG
хүлээс	хүлээсээр	N;INS;SG
эзэмшигч	эзэмшигчийн	N;GEN;SG
гэрэлтүүлэг	гэрэлтүүлгийг	N;ACC;SG
холестерин	холестериноо	N;VOC;SG
чийг	чийгийн	N;GEN;SG
чансаа	чансаанаас	N;ABL;SG
ижилсэл	ижилслийг	N;ACC;SG
хөрөг	хөргөөр	N;INS;SG
урхи	урхины	N;GEN;SG
бөндгөр	бөндгөрөөс	N;ABL;SG
зэрэглээ	зэрэглээгээ	N;VOC;SG
аваар	аваарыг	N;ACC;SG
хангамж	хангамжийг	N;ACC;SG
сүр	сүрээр	N;INS;SG
цөм	цөмөөс	N;ABL;SG
гитар	гитарыг	N;ACC;SG
агуулах	агуулахаас	N;ABL;SG
зааг	заагаас	N;ABL;SG
салбар	салбараа	N;VOC;SG
ястан	ястнаас	N;ABL;SG
хэмнэл	хэмнэлээр	N;INS;SG
барьцалдаа	барьцалдаагаа	N;VOC;SG
төмсөг	төмсгөөс	N;ABL;SG
алчуур	алчуурыг	N;ACC;SG
илтгэл	илтгэлийн	N;GEN;SG
уран	уранаа	N;VOC;SG
цогцос	цогцсоо	N;VOC;SG
дарангуйлал	дарангуйллыг	N;ACC;SG
уурхайчин	уурхайчны	N;GEN;SG
онгод	онгодоор	N;INS;SG
шалгагч	шалгагчаа	N;VOC;SG
дарга	даргыг	N;ACC;SG
чийг	чийгээс	N;ABL;SG
хуваагдагч	хуваагдагчаар	N;INS;SG
удамшил	удамшлаас	N;ABL;SG
ангилал	ангиллаа	N;VOC;SG
чөмөг	чөмгийг	N;ACC;SG
сүйтгэгч	сүйтгэгчийг	N;ACC;SG
цэнгүүн	цэнгүүнээс	N;ABL;SG
дуншилт	дуншилтын	N;GEN;SG
мэхлэлт	мэхлэлтээр	N;INS;SG
хоосрох	хоосорчих	V;IMP;SG+PL;2
мөрдөлт	мөрдөлтийн	N;GEN;SG
бараа	барааны	N;GEN;SG
завхайрал	завхайрлаас	N;ABL;SG
хардалт	хардалтаас	N;ABL;SG
засварчин	засварчны	N;GEN;SG
луус	лууснаас	N;ABL;SG
ээтийх	авхуулчих	V;IMP;SG+PL;2
аялга	аялгыг	N;ACC;SG
хорхой	хорхойгоор	N;INS;SG
суурь	сууриа	N;VOC;SG
чөтгөр	чөтгөрөө	N;VOC;SG
эрэл	эрлийн	N;GEN;SG
үнэлэлт	үнэлэлтээс	N;ABL;SG
хурим	хуримаас	N;ABL;SG
зангиа	зангианы	N;GEN;SG
мөргөл	мөргөлийн	N;GEN;SG
квадрат	квадратыг	N;ACC;SG
капитал	капиталаар	N;INS;SG
томьёо	томьёогоор	N;INS;SG
холбоос	холбоосоо	N;VOC;SG
асуулт	асуултын	N;GEN;SG
гараг	гаргаар	N;INS;SG
эрхлэгч	эрхлэгчийн	N;GEN;SG
зүтгэл	зүтгэлээр	N;INS;SG
гортиг	гортигоор	N;INS;SG
хуяг	хуягийг	N;ACC;SG
зохиол	зохиолоос	N;ABL;SG
эсэргүүцэл	эсэргүүцлээс	N;ABL;SG
шумбагч	шумбагчийг	N;ACC;SG
дургүйцэл	дургүйцлийн	N;GEN;SG
тахиа	тахианы	N;GEN;SG
нэхэмжлэгч	нэхэмжлэгчээс	N;ABL;SG
шимтгэл	шимтгэлийг	N;ACC;SG
наймаачин	наймаачныг	N;ACC;SG
эх	эхээр	N;INS;SG
зай	зайн	N;GEN;SG
эрэмбэ	эрэмбээ	N;VOC;SG
лууван	луувангийн	N;GEN;SG
кредит	кредитийг	N;ACC;SG
гариг	гаригаар	N;INS;SG
уулзалт	уулзалтыг	N;ACC;SG
кино	киноны	N;GEN;SG
бүлүүр	бүлүүрээс	N;ABL;SG
зам	замыг	N;ACC;SG
ургац	ургацыг	N;ACC;SG
дэлхий	дэлхийгээр	N;INS;SG
онгоц	онгоцоо	N;VOC;SG
талбай	талбайгаар	N;INS;SG
босго	босгыг	N;ACC;SG
мах	махыг	N;ACC;SG
бай	байгаар	N;INS;SG
солио	солионоос	N;ABL;SG
үсрэлт	үсрэлтээр	N;INS;SG
мэтгэлцээн	мэтгэлцээний	N;GEN;SG
андгай	андгайгаа	N;VOC;SG
мөргөл	мөргөлөө	N;VOC;SG
хэвлэгч	хэвлэгчээр	N;INS;SG
оргодол	оргодлоор	N;INS;SG
ёзоор	ёзоорын	N;GEN;SG
шүтэлцээ	шүтэлцээгээ	N;VOC;SG
тооцоо	тооцооны	N;GEN;SG
сунгалт	сунгалтаар	N;INS;SG
цохих	цохивол	V.CVB;LGSPEC03
багана	баганын	N;GEN;SG
бүртгэл	бүртгэлийн	N;GEN;SG
эрдэс	эрдсийн	N;GEN;SG
үүсгэл	үүсгэлээ	N;VOC;SG
голомт	голомтыг	N;ACC;SG
хуваагдал	хуваагдлыг	N;ACC;SG
саа	саагаа	N;VOC;SG
стандарт	стандартын	N;GEN;SG
бэлгэвч	бэлгэвчнээс	N;ABL;SG
дагавар	дагавраа	N;VOC;SG
инерц	инерцээр	N;INS;SG
булш	булшаар	N;INS;SG
хамгаалагч	хамгаалагчийн	N;GEN;SG
амьдрал	амьдралаа	N;VOC;SG
теннис	теннисээс	N;ABL;SG
өчиг	өчгөөр	N;INS;SG
амттан	амттанаар	N;INS;SG
зугтуул	зугтуулын	N;GEN;SG
гоёл	гоёлын	N;GEN;SG
углааш	углаашийн	N;GEN;SG
хэрчим	хэрчмийг	N;ACC;SG
айдас	айдсаар	N;INS;SG
түйвээн	түйвээнээр	N;INS;SG
гоймон	гоймонгоос	N;ABL;SG
төрөл	төрлийг	N;ACC;SG
хэрэгтэй	хэргийн	N;GEN;SG
шүүс	шүүсээс	N;ABL;SG
тээвэрлэлт	тээвэрлэлтээс	N;ABL;SG
шавхай	шавхайнаас	N;ABL;SG
маркетинг	маркетингийг	N;ACC;SG
идэгдэл	идэгдлээ	N;VOC;SG
ритм	ритмээс	N;ABL;SG
зөн	зөнг	N;ACC;SG
ноогдол	ноогдлоос	N;ABL;SG
гаслан	гаслангийн	N;GEN;SG
баримжаа	баримжааг	N;ACC;SG
тэврэлт	тэврэлтээ	N;VOC;SG
хүчилтөрөгч	хүчилтөрөгчийг	N;ACC;SG
халдлага	халдлагаас	N;ABL;SG
дарлал	дарлалын	N;GEN;SG
жорлон	жорлонгийн	N;GEN;SG
фашизм	фашизмаар	N;INS;SG
дампуурал	дампуурлаар	N;INS;SG
ширэг	ширгээ	N;VOC;SG
инерц	инерцийн	N;GEN;SG
давс	давсны	N;GEN;SG
тэнүүл	тэнүүлээр	N;INS;SG
илэрхийлэл	илэрхийллийн	N;GEN;SG
үхэл	үхлээс	N;ABL;SG
тариа	тариагаа	N;VOC;SG
эгч	эгчээс	N;ABL;SG
редактор	редактораа	N;VOC;SG
гирвэших	ирвэгэнэцгээ	V;IMP;PL;2;PRS
шуудуу	шуудуунаас	N;ABL;SG
товчлуур	товчлуураар	N;INS;SG
донсолгоо	донсолгооны	N;GEN;SG
тариа	тариаг	N;ACC;SG
тамхи	тамхиа	N;VOC;SG
зүрхтэй	зүрхээ	N;VOC;SG
хошууч	хошуучаас	N;ABL;SG
махчин	махчны	N;GEN;SG
жолоо	жолоог	N;ACC;SG
ялагдагч	ялагдагчаа	N;VOC;SG
овоолох	овоолцгоо	V;IMP;PL;2;PRS
өргөтгөл	өргөтгөлийн	N;GEN;SG
цилиндр	цилиндрээс	N;ABL;SG
давхарга	давхаргаар	N;INS;SG
биллиард	биллиардын	N;GEN;SG
сүнс	сүнсийг	N;ACC;SG
дэвүүр	дэвүүрээс	N;ABL;SG
шаналал	шаналлаа	N;VOC;SG
гүүр	гүүрээс	N;ABL;SG
хожуул	хожуулын	N;GEN;SG
уншигч	уншигчаас	N;ABL;SG
цэр	цэрээ	N;VOC;SG
дамжаа	дамжааны	N;GEN;SG
гэрлэлт	гэрлэлтийн	N;GEN;SG
өмгөөлөгч	өмгөөлөгчөөр	N;INS;SG
доройтол	доройтлоор	N;INS;SG
фронт	фронтоос	N;ABL;SG
суурь	сууриас	N;ABL;SG
хэмжигдэхүүн	хэмжигдэхүүний	N;GEN;SG
бадмаараг	бадмааргаа	N;VOC;SG
тэнцэтгэл	тэнцэтгэлээс	N;ABL;SG
хориг	хоригийг	N;ACC;SG
шарил	шарилыг	N;ACC;SG
бичиглэл	бичиглэлийг	N;ACC;SG
мөрдөс	мөрдөсний	N;GEN;SG
нийгэмлэг	нийгэмлэгээр	N;INS;SG
гимнастик	гимнастикаар	N;INS;SG
гүүр	гүүрээр	N;INS;SG
дарангуйлагч	дарангуйлагчаа	N;VOC;SG
бүтээгдэхүүн	бүтээгдэхүүний	N;GEN;SG
судал	судлаас	N;ABL;SG
олс	олсны	N;GEN;SG
огтлолцол	огтлолцлоор	N;INS;SG
бүтээл	бүтээлийг	N;ACC;SG
хавч	хавчнаас	N;ABL;SG
түлхүүр	түлхүүрээс	N;ABL;SG
лавлагаа	лавлагааг	N;ACC;SG
моод	моодны	N;GEN;SG
хашилт	хашилтаа	N;VOC;SG
бүрээс	бүрээсээс	N;ABL;SG
тайрдас	тайрдаснаас	N;ABL;SG
лектор	лекторыг	N;ACC;SG
худалдаа	худалдааг	N;ACC;SG
шүлсэвч	шүлсэвчийг	N;ACC;SG
дадал	дадлыг	N;ACC;SG
эмгэнэл	эмгэнэлийг	N;ACC;SG
дүрс	дүрсээ	N;VOC;SG
эвлэрүүлэгч	эвлэрүүлэгчийн	N;GEN;SG
ресторан	ресторанаас	N;ABL;SG
түгжрэл	түгжрэлээ	N;VOC;SG
диаметр	диаметрийн	N;GEN;SG
бөгс	бөгсний	N;GEN;SG
зэрэглээ	зэрэглээгээр	N;INS;SG
олтриг	олтригийг	N;ACC;SG
бассейн	бассейнаар	N;INS;SG
сэв	сэвийг	N;ACC;SG
фокус	фокусаар	N;INS;SG
хөтлөгч	хөтлөгчийн	N;GEN;SG
гох	гохоо	N;VOC;SG
барих	барив	V;PRF;IND;PRS
дургүйцэл	дургүйцлийг	N;ACC;SG
дүрэм	дүрмээр	N;INS;SG
хөвөн	хөвөнг	N;ACC;SG
овог	овгийн	N;GEN;SG
охин	охиныг	N;ACC;SG
хэвшил	хэвшлийн	N;GEN;SG
тах	тахны	N;GEN;SG
зугаатай	зугаагаар	N;INS;SG
зурагчин	зурагчнаа	N;VOC;SG
мастер	мастерыг	N;ACC;SG
дулаарах	дулаарсан	V;IND;PST
зэс	зэсийг	N;ACC;SG
ижилсэл	ижилслээ	N;VOC;SG
хормой	хормойноос	N;ABL;SG
асар	асраа	N;VOC;SG
фокус	фокусыг	N;ACC;SG
чихэр	чихрээ	N;VOC;SG
удамшил	удамшлын	N;GEN;SG
дух	духны	N;GEN;SG
булдруу	булдруунаас	N;ABL;SG
дэвшил	дэвшлээ	N;VOC;SG
хөшүүрэг	хөшүүргийн	N;GEN;SG
адмирал	адмиралаар	N;INS;SG
багс	багсаа	N;VOC;SG
зэв	зэвийг	N;ACC;SG
цуврал	цувралаас	N;ABL;SG
зөрчигч	зөрчигчийн	N;GEN;SG
тайрдас	тайрдасны	N;GEN;SG
түрээслэгч	түрээслэгчээр	N;INS;SG
эзэгнэл	эзэгнэлийг	N;ACC;SG
мөхөл	мөхлийг	N;ACC;SG
цай	цайгаа	N;VOC;SG
язгууртан	язгууртныг	N;ACC;SG
бялуу	бялууны	N;GEN;SG
хөгжилтэй	хөгжлийн	N;GEN;SG
цөс	цөснөөс	N;ABL;SG
хавчаар	хавчаарын	N;GEN;SG
дайчилгаа	дайчилгаагаа	N;VOC;SG
фронт	фронтыг	N;ACC;SG
нөхөр	нөхрийн	N;GEN;SG
гагнуур	гагнуураас	N;ABL;SG
бодрол	бодролоо	N;VOC;SG
дэлгэрэлт	дэлгэрэлтийг	N;ACC;SG
хорих	хорьцгоо	V;IMP;PL;2;PRS
соруул	соруулаар	N;INS;SG
бүтээгдэхүүн	бүтээгдэхүүнээс	N;ABL;SG
түрэмгийлэл	түрэмгийллийн	N;GEN;SG
урвал	урвалаа	N;VOC;SG
хурд	хурдаар	N;INS;SG
тамхи	тамхийг	N;ACC;SG
товойх	товойв	V;PRF;IND;PRS
хошин	хошингоор	N;INS;SG
майонез	майонезаа	N;VOC;SG
наалт	наалтын	N;GEN;SG
бичиг	бичгээс	N;ABL;SG
бүсгүй	бүсгүйн	N;GEN;SG
арьс	арьсны	N;GEN;SG
төвлөрөл	төвлөрлөөс	N;ABL;SG
шүлт	шүлтээ	N;VOC;SG
цэрд	цэрдээс	N;ABL;SG
халдлага	халдлагыг	N;ACC;SG
нөлөө	нөлөөгөөр	N;INS;SG
захидал	захидлыг	N;ACC;SG
ирц	ирцээ	N;VOC;SG
самуун	самуунаас	N;ABL;SG
уралдаан	уралдаанаар	N;INS;SG
хавчаар	хавчаараас	N;ABL;SG
өмхий	өмхийийг	N;ACC;SG
инээмсэглэл	инээмсэглэлийг	N;ACC;SG
байршил	байршлаас	N;ABL;SG
гадар	гадраар	N;INS;SG
өвчтөн	өвчтөнөөр	N;INS;SG
суралцагч	суралцагчийн	N;GEN;SG
боол	боолоор	N;INS;SG
арилжаа	арилжаагаа	N;VOC;SG
явдал	явдлаас	N;ABL;SG
оноо	оноог	N;ACC;SG
аварга	аваргаар	N;INS;SG
арьс	арьсаа	N;VOC;SG
сагаг	сагагаа	N;VOC;SG
үсэглэл	үсэглэлийн	N;GEN;SG
чангарал	чангарлыг	N;ACC;SG
талбар	талбараа	N;VOC;SG
мөчир	мөчрөөс	N;ABL;SG
нэмэлт	нэмэлтээ	N;VOC;SG
уулзвар	уулзвараар	N;INS;SG
хошуучлагч	хошуучлагчаа	N;VOC;SG
болзоо	болзоогоо	N;VOC;SG
иш	ишийн	N;GEN;SG
эрдэнэс	эрдэнэсээс	N;ABL;SG
цуглуулагч	цуглуулагчийг	N;ACC;SG
эвсэл	эвслээр	N;INS;SG
туйл	туйлаар	N;INS;SG
масштаб	масштабыг	N;ACC;SG
бадаг	бадгийг	N;ACC;SG
дилер	дилерээр	N;INS;SG
шороо	шороогоор	N;INS;SG
автобус	автобусаар	N;INS;SG
фокус	фокусаа	N;VOC;SG
найдлага	найдлагын	N;GEN;SG
радиус	радиусаа	N;VOC;SG
цуурай	цуурайнаас	N;ABL;SG
яндан	яндангаа	N;VOC;SG
төсөл	төслөөр	N;INS;SG
стандарт	стандартаас	N;ABL;SG
гамшиг	гамшгаа	N;VOC;SG
дүүжин	дүүжингээс	N;ABL;SG
шээс	шээсний	N;GEN;SG
хэц	хэцийн	N;GEN;SG
шоглоом	шоглоомын	N;GEN;SG
найрлага	найрлагаа	N;VOC;SG
эгзэгтэй	эгзгээр	N;INS;SG
тэвхдэх	тэвхэдчих	V;IMP;SG+PL;2
өвөрлөх	өвөрлөө	V;PRF;IND;PRS
наадгай	наадгайн	N;GEN;SG
хулгана	хулганаа	N;VOC;SG
хавтас	хавтсаа	N;VOC;SG
цоож	цоожоор	N;INS;SG
дулаарах	дулаарав	V;PRF;IND;PRS
экватор	экватораас	N;ABL;SG
заан	заанаар	N;INS;SG
роман	романыг	N;ACC;SG
хамсаатан	хамсаатнаас	N;ABL;SG
ахлагч	ахлагчаар	N;INS;SG
хүч	хүчээр	N;INS;SG
бэртэлт	бэртэлтээс	N;ABL;SG
зохицуулалт	зохицуулалтын	N;GEN;SG
гологдол	гологдлоор	N;INS;SG
онцлог	онцлогоор	N;INS;SG
хатгамал	хатгамлаа	N;VOC;SG
хорио	хорионы	N;GEN;SG
өвдөг	өвдгөө	N;VOC;SG
түүх	түүхийг	N;ACC;SG
машин	машиныг	N;ACC;SG
хушга	хушгыг	N;ACC;SG
ээж	ээжээ	N;VOC;SG
мөргөлдөөн	мөргөлдөөнөөс	N;ABL;SG
бэлхүүсэвч	бэлхүүсэвчийг	N;ACC;SG
гичий	гичийгээс	N;ABL;SG
өөрчлөлт	өөрчлөлтөөс	N;ABL;SG
хэмнэл	хэмнэлийг	N;ACC;SG
тайлбар	тайлбараар	N;INS;SG
гаанс	гаансаар	N;INS;SG
хүчээр	хүчээ	N;VOC;SG
бүсгүй	бүсгүйг	N;ACC;SG
эргэцүүлэл	эргэцүүллийн	N;GEN;SG
дамчин	дамчныг	N;ACC;SG
суултуур	суултуураар	N;INS;SG
эмэгтэйчүүд	харьтаа	N;VOC;SG
эрин	эринийг	N;ACC;SG
бүлэглэл	бүлэглэлээс	N;ABL;SG
шүүмжлэгч	шүүмжлэгчээр	N;INS;SG
мэнгэ	мэнгэнээс	N;ABL;SG
нойр	нойрноос	N;ABL;SG
гарз	гарзнаас	N;ABL;SG
хүрээ	хүрээгээр	N;INS;SG
мэдээлэл	мэдээллийг	N;ACC;SG
хэмжээс	хэмжээсээ	N;VOC;SG
амлалт	амлалтын	N;GEN;SG
тэтгэмж	тэтгэмжээс	N;ABL;SG
сэргээлт	сэргээлтийн	N;GEN;SG
хуудас	хуудаснаас	N;ABL;SG
ажилтан	ажилтныг	N;ACC;SG
ахмад	ахмадыг	N;ACC;SG
шаантаг	шаантгаа	N;VOC;SG
мэх	мэхийг	N;ACC;SG
зэмлэл	зэмлэлээс	N;ABL;SG
капсул	капсулаа	N;VOC;SG
цуврал	цувралын	N;GEN;SG
жишээ	жишээгээр	N;INS;SG
төвлөрүүлэлт	төвлөрүүлэлтээс	N;ABL;SG
текст	текстийг	N;ACC;SG
арга	аргаа	N;VOC;SG
тэсвэр	тэсвэрээ	N;VOC;SG
судлаач	судлаачаар	N;INS;SG
суудал	суудлыг	N;ACC;SG
дов	довоо	N;VOC;SG
хязгаар	хязгаараас	N;ABL;SG
тэргүүлэгчид	тэргүүлэгчээс	N;ABL;SG
зураач	зураачаа	N;VOC;SG
физиологи	физиологийн	N;GEN;SG
дизайнер	дизайнерын	N;GEN;SG
дахилт	дахилтын	N;GEN;SG
тармуур	тармуурыг	N;ACC;SG
хавирга	хавиргаа	N;VOC;SG
амар	амраас	N;ABL;SG
гишүүн	гишүүнээс	N;ABL;SG
загатнаа	загатнаанаас	N;ABL;SG
археологи	археологиос	N;ABL;SG
ордон	ордны	N;GEN;SG
эрдэмтэн	эрдэмтнийг	N;ACC;SG
нөлөө	нөлөөгөө	N;VOC;SG
хуульч	хуульчаа	N;VOC;SG
ширэнгэ	ширэнгийг	N;ACC;SG
залилан	залилангаа	N;VOC;SG
сүнс	сүнсээр	N;INS;SG
нийлүүлэлт	нийлүүлэлтээ	N;VOC;SG
үргүйдэл	үргүйдлээр	N;INS;SG
бадаг	бадгаас	N;ABL;SG
захиалагч	захиалагчийн	N;GEN;SG
хайрцаг	хайрцгаа	N;VOC;SG
солилцоо	солилцоогоор	N;INS;SG
хүрэм	хүрмээр	N;INS;SG
лак	лакийг	N;ACC;SG
илгээмж	илгээмжийг	N;ACC;SG
сүү	сүүгээ	N;VOC;SG
шунал	шуналаа	N;VOC;SG
хэлмэгдэх	хэлмэгджээ	V;IND;PST
экосистем	экосистемийн	N;GEN;SG
цагцгай	цагцгайн	N;GEN;SG
хөдөс	хөдсийг	N;ACC;SG
үерхэл	үерхлээс	N;ABL;SG
шалтгаан	шалтгааны	N;GEN;SG
ашигтай	ашгаар	N;INS;SG
эзэмшигч	эзэмшигчээс	N;ABL;SG
компьютер	компьютероор	N;INS;SG
голомт	голомтоо	N;VOC;SG
тэсрэлт	тэсрэлтээс	N;ABL;SG
горьдлого	горьдлогыг	N;ACC;SG
гишүүн	гишүүнээр	N;INS;SG
төр	төрөөс	N;ABL;SG
далдлалт	далдлалтаа	N;VOC;SG
паалан	паалангаа	N;VOC;SG
дайсан	дайсныг	N;ACC;SG
жүжигчин	жүжигчнээр	N;INS;SG
цэврүү	цэврүүг	N;ACC;SG
тэмтрэх	тэмтэрвэл	V.CVB;LGSPEC03
сахиус	сахиусны	N;GEN;SG
академи	академиас	N;ABL;SG
төлөвлөгөө	төлөвлөгөөнөөс	N;ABL;SG
тэнцэтгэл	тэнцэтгэлээ	N;VOC;SG
долгио	долгиогоо	N;VOC;SG
ээтийх	ээтийгээрэй	V;IMP;PL;2;PRS
синдром	синдромоос	N;ABL;SG
хэл	хэлээ	N;VOC;SG
үйлчлүүлэгч	үйлчлүүлэгчээ	N;VOC;SG
донсолгоо	донсолгоогоор	N;INS;SG
атираа	атираанаас	N;ABL;SG
нугас	нугасаа	N;VOC;SG
адгуус	адгуусаа	N;VOC;SG
нойр	нойроо	N;VOC;SG
нүүрстөрөгч	нүүрстөрөгчийн	N;GEN;SG
уях	уячих	V;IMP;SG+PL;2
голомт	голомтын	N;GEN;SG
эзэмшил	эзэмшлээс	N;ABL;SG
хямрал	хямралын	N;GEN;SG
хямдрал	хямдралыг	N;ACC;SG
хашлага	хашлагаа	N;VOC;SG
үйс	үйсийг	N;ACC;SG
өвчтөн	өвчтөний	N;GEN;SG
бэр	бэрээс	N;ABL;SG
шороо	шорооноос	N;ABL;SG
тавиур	тавиурын	N;GEN;SG
цэврүү	цэврүүнээс	N;ABL;SG
зурхай	зурхайгаар	N;INS;SG
үнсэлт	үнсэлтээ	N;VOC;SG
өгүүлэгдэхүүн	өгүүлэгдэхүүнийг	N;ACC;SG
соруул	соруулын	N;GEN;SG
жинлүүр	жинлүүрээс	N;ABL;SG
хүчилтөрөгч	хүчилтөрөгчөө	N;VOC;SG
зохиол	зохиолоор	N;INS;SG
суман	сумангаас	N;ABL;SG
чулуу	чулуугаар	N;INS;SG
карт	картаас	N;ABL;SG
дохиур	дохиураа	N;VOC;SG
сүү	сүүнээс	N;ABL;SG
бүлэг	бүлгээс	N;ABL;SG
доллар	доллароор	N;INS;SG
танхим	танхимаас	N;ABL;SG
хүүрнэл	хүүрнэлээр	N;INS;SG
улангир	улангираас	N;ABL;SG
хальс	хальсыг	N;ACC;SG
хөлс	хөлсөө	N;VOC;SG
хэллэг	хэллэгээс	N;ABL;SG
туйл	туйлаас	N;ABL;SG
туулай	туулайнаас	N;ABL;SG
конус	конусыг	N;ACC;SG
эрэлт	эрэлтээ	N;VOC;SG
дилер	дилерийн	N;GEN;SG
нийлбэр	нийлбэрээс	N;ABL;SG
дарамт	дарамтыг	N;ACC;SG
захиргаа	захиргааны	N;GEN;SG
дарангуйлагч	дарангуйлагчийн	N;GEN;SG
үсчин	үсчнээс	N;ABL;SG
зуучлагч	зуучлагчийг	N;ACC;SG
зулгаах	зулгаасан	V;IND;PST
тууралт	тууралтын	N;GEN;SG
ууршилт	ууршилтыг	N;ACC;SG
хүндрэл	хүндрэлээр	N;INS;SG
ухагдахуун	ухагдахуунаар	N;INS;SG
ая	аяар	N;INS;SG
тайлбарлагч	тайлбарлагчийн	N;GEN;SG
зүтгэл	зүтгэлийг	N;ACC;SG
ургацаг	ургацгаас	N;ABL;SG
ялагдал	ялагдлаар	N;INS;SG
сүйрэл	сүйрлээ	N;VOC;SG
хүүрнэл	хүүрнэлээс	N;ABL;SG
инээдэм	инээдмээр	N;INS;SG
хөдөлгүүр	хөдөлгүүрийн	N;GEN;SG
алхаа	алхаагаа	N;VOC;SG
амжилт	амжилтаас	N;ABL;SG
дүн	дүнгийн	N;GEN;SG
хууль	хуулийг	N;ACC;SG
экватор	экватораа	N;VOC;SG
орогнох	товойцгоо	V;IMP;PL;2;PRS
гирвэших	ирвэгэнэв	V;PRF;IND;PRS
хөндийрөх	хөндийрвөл	V.CVB;LGSPEC03
бүртгэл	бүртгэлээр	N;INS;SG
хонь	хониор	N;INS;SG
үзүүлбэр	үзүүлбэрээр	N;INS;SG
мөргөлдөөн	мөргөлдөөнийг	N;ACC;SG
мөргөл	мөргөлөөр	N;INS;SG
аваар	аваараар	N;INS;SG
суултуур	суултуураас	N;ABL;SG
дүнз	дүнзээс	N;ABL;SG
ногт	ногтны	N;GEN;SG
бэлхүүсэвч	бэлхүүсэвчээр	N;INS;SG
буга	бугаас	N;ABL;SG
үргээгч	үргээгчээ	N;VOC;SG
шоглоом	шоглоомыг	N;ACC;SG
зангилаа	зангилааг	N;ACC;SG
уурхай	уурхайнаас	N;ABL;SG
тоть	тотио	N;VOC;SG
гортиг	гортигийг	N;ACC;SG
үнэлгээ	үнэлгээг	N;ACC;SG
этгээд	этгээдийг	N;ACC;SG
дугтуй	дугтуйгаа	N;VOC;SG
мэтгэлцэгч	мэтгэлцэгчээ	N;VOC;SG
тэнхлэг	тэнхлэгээс	N;ABL;SG
бижрүү	бижрүүг	N;ACC;SG
ялгалт	ялгалтаа	N;VOC;SG
зүг	зүгээр	N;INS;SG
хэлэлцэгч	хэлэлцэгчээр	N;INS;SG
сүм	сүмээ	N;VOC;SG
зөгнөл	зөгнөлөөр	N;INS;SG
дүрэм	дүрмийн	N;GEN;SG
хэв	хэвийг	N;ACC;SG
аялгуу	аялгууг	N;ACC;SG
айдас	айдсаа	N;VOC;SG
дуудлага	дуудлагын	N;GEN;SG
тугалга	тугалганы	N;GEN;SG
үнэлгээ	үнэлгээгээ	N;VOC;SG
шуудай	шуудайг	N;ACC;SG
хэрэгжилт	хэрэгжилтээр	N;INS;SG
хөтөлбөр	хөтөлбөрийг	N;ACC;SG
цомог	цомгоос	N;ABL;SG
зохиомж	зохиомжийг	N;ACC;SG
реализм	реализмаар	N;INS;SG
гахиур	гахиурын	N;GEN;SG
атом	атомын	N;GEN;SG
даажигнал	даажигналыг	N;ACC;SG
хатуурал	хатуурлын	N;GEN;SG
түгжрэл	түгжрэлээр	N;INS;SG
дамчин	дамчны	N;GEN;SG
залгаас	залгааснаас	N;ABL;SG
хоног	хоногийг	N;ACC;SG
доллар	доллароос	N;ABL;SG
урлаг	урлагаар	N;INS;SG
тоосго	тоосгоо	N;VOC;SG
эргэлзэл	эргэлзлээс	N;ABL;SG
хуваарилалт	хуваарилалтаар	N;INS;SG
сүй	сүйгээ	N;VOC;SG
гадас	гадасны	N;GEN;SG
цуглуулга	цуглуулгаас	N;ABL;SG
онгод	онгодоо	N;VOC;SG
могой	могойгоос	N;ABL;SG
захиа	захианы	N;GEN;SG
онош	оношны	N;GEN;SG
он	оноор	N;INS;SG
огтлолцол	огтлолцлыг	N;ACC;SG
масло	маслонаас	N;ABL;SG
хийсвэрлэл	хийсвэрлэлийг	N;ACC;SG
бэлхүүсэвч	бэлхүүсэвчээ	N;VOC;SG
соёлжих	соёлжчих	V;IMP;SG+PL;2
арбитр	арбитрыг	N;ACC;SG
савхи	савхинаас	N;ABL;SG
бичиглэл	бичиглэлийн	N;GEN;SG
цогцос	цогцсын	N;GEN;SG
явуулга	явуулгаар	N;INS;SG
оролцоо	оролцооноос	N;ABL;SG
онолч	онолчоо	N;VOC;SG
наймаа	наймаагаа	N;VOC;SG
мөнх	мөнхөө	N;VOC;SG
мэтгэлцэгч	мэтгэлцэгчээс	N;ABL;SG
углааш	углаашаас	N;ABL;SG
слайд	слайдаар	N;INS;SG
хяналт	хяналтаа	N;VOC;SG
ирмэг	ирмэгээ	N;VOC;SG
дохио	дохиог	N;ACC;SG
дүрслэл	дүрслэлийг	N;ACC;SG
арми	армиас	N;ABL;SG
бөглөрөл	бөглөрлөөс	N;ABL;SG
үе	үеийг	N;ACC;SG
нөхвөр	нөхвөрийг	N;ACC;SG
шургуулга	шургуулгаас	N;ABL;SG
майхан	майхнаар	N;INS;SG
болжмор	болжмороор	N;INS;SG
танил	танилаас	N;ABL;SG
ашиг	ашгаас	N;ABL;SG
тарга	таргын	N;GEN;SG
хувьцаа	хувьцаанаас	N;ABL;SG
даралт	даралтыг	N;ACC;SG
багц	багцаа	N;VOC;SG
манан	мананг	N;ACC;SG
амралт	амралтаа	N;VOC;SG
хариу	хариугаа	N;VOC;SG
эмнэлэг	эмнэлгээр	N;INS;SG
ташуур	ташуурыг	N;ACC;SG
символизм	символизмоо	N;VOC;SG
бэлэг	бэлгээр	N;INS;SG
гуйлгачин	гуйлгачныг	N;ACC;SG
зогдор	зогдрыг	N;ACC;SG
дамжуулалт	дамжуулалтаар	N;INS;SG
хөрөөдөх	өвөрлөсөн	V;IND;PST
ус	усны	N;GEN;SG
хойг	хойгоор	N;INS;SG
найруулга	найруулгаас	N;ABL;SG
дасгал	дасгалаас	N;ABL;SG
үнэр	үнэрийн	N;GEN;SG
бүрэлбаа	бүрэлбаагаа	N;VOC;SG
галзуурал	галзуурлыг	N;ACC;SG
бөндгөр	бөндгөрөө	N;VOC;SG
шороо	шороогоо	N;VOC;SG
тогтолцоо	тогтолцооноос	N;ABL;SG
тэлээ	тэлээгээ	N;VOC;SG
өд	өдийг	N;ACC;SG
эргэцүүлэл	эргэцүүллээр	N;INS;SG
загасчин	загасчнаар	N;INS;SG
хоч	хочноос	N;ABL;SG
доройтол	доройтлын	N;GEN;SG
хаалт	хаалтыг	N;ACC;SG
хоршил	хоршлоор	N;INS;SG
амьдчилал	амьдчиллаас	N;ABL;SG
ургацаг	ургацгаа	N;VOC;SG
гацуур	гацуураас	N;ABL;SG
ёслол	ёслолоос	N;ABL;SG
булчин	булчингаас	N;ABL;SG
жүрж	жүржээс	N;ABL;SG
барцад	барцдаар	N;INS;SG
танго	тангоноос	N;ABL;SG
жишиг	жишгээ	N;VOC;SG
ээтийх	ээтийжээ	V;IND;PST
хашилт	хашилтыг	N;ACC;SG
оршил	оршлын	N;GEN;SG
эм	эмийг	N;ACC;SG
төсөв	төсвөөс	N;ABL;SG
хүч	хүчний	N;GEN;SG
инээдэм	инээдмээс	N;ABL;SG
уйтгар	уйтгарыг	N;ACC;SG
өөрчлөгч	өөрчлөгчийн	N;GEN;SG
ламп	лампаа	N;VOC;SG
урхи	урхийг	N;ACC;SG
сэжигтэн	сэжигтнээс	N;ABL;SG
тогтворжуулалт	тогтворжуулалтаа	N;VOC;SG
уйтгартай	уйтгараар	N;INS;SG
нидрүүлэг	нидрүүлгээс	N;ABL;SG
тактик	тактикаас	N;ABL;SG
зураас	зураасаа	N;VOC;SG
мөгөөрс	мөгөөрсөө	N;VOC;SG
хүйтэн	хүйтнээр	N;INS;SG
чангарал	чангарлын	N;GEN;SG
могой	могойгоо	N;VOC;SG
сонгууль	сонгуулиар	N;INS;SG
шүүмжлэл	шүүмжлэлийг	N;ACC;SG
бүрээс	бүрээсний	N;GEN;SG
тариа	тарианаас	N;ABL;SG
цирк	циркийг	N;ACC;SG
гадар	гадрын	N;GEN;SG
том	томын	N;GEN;SG
үерхэл	үерхлээ	N;VOC;SG
хувилбар	хувилбараа	N;VOC;SG
сүйрэл	сүйрлийг	N;ACC;SG
мэргэ	мэргэнээс	N;ABL;SG
мэдэгдэл	мэдэгдлийг	N;ACC;SG
хэрэгтэй	хэргээр	N;INS;SG
элч	элчийг	N;ACC;SG
өвөө	өвөөгөөр	N;INS;SG
оновчтой	оновчоор	N;INS;SG
зөвшилцөл	зөвшилцлөөс	N;ABL;SG
гялтгануур	гялтгануураар	N;INS;SG
хутга	хутгаа	N;VOC;SG
цэвэрлэгээ	цэвэрлэгээний	N;GEN;SG
капсул	капсулаас	N;ABL;SG
хориг	хоригоор	N;INS;SG
залгамжлагч	залгамжлагчийг	N;ACC;SG
компани	компаниас	N;ABL;SG
шар	шараас	N;ABL;SG
хормой	хормойгоо	N;VOC;SG
роман	романаа	N;VOC;SG
медаль	медалиар	N;INS;SG
харамсал	харамслаа	N;VOC;SG
ресторан	рестораны	N;GEN;SG
аалз	аалзнаас	N;ABL;SG
сануулга	сануулгыг	N;ACC;SG
сургууль	сургуулиас	N;ABL;SG
зоодой	зоодойн	N;GEN;SG
үүл	үүлээр	N;INS;SG
тодорхойлолт	тодорхойлолтоос	N;ABL;SG
хорих	хорьчих	V;IMP;SG+PL;2
соёлжих	соёлжицгоо	V;IMP;PL;2;PRS
орой	оройг	N;ACC;SG
загасчин	загасчны	N;GEN;SG
гортиг	гортигоос	N;ABL;SG
атаархал	атаархлаас	N;ABL;SG
зохиогч	зохиогчоо	N;VOC;SG
чуулга	чуулгаар	N;INS;SG
дух	духыг	N;ACC;SG
барьцаа	барьцаанаас	N;ABL;SG
хүзүү	хүзүүгээ	N;VOC;SG
шүүр	шүүрээ	N;VOC;SG
мэрэгч	мэрэгчээр	N;INS;SG
нүд	нүдээс	N;ABL;SG
луйвар	луйвраа	N;VOC;SG
цөс	цөсөөр	N;INS;SG
яс	ясаа	N;VOC;SG
далдлалт	далдлалтаас	N;ABL;SG
голд	голоос	N;ABL;SG
сахиус	сахиусыг	N;ACC;SG
шөвхлөх	шөвхөлсөн	V;IND;PST
керамик	керамикийн	N;GEN;SG
өсөлт	өсөлтийг	N;ACC;SG
гадил	гадилын	N;GEN;SG
зээрэнцэг	зээрэнцгээр	N;INS;SG
долгион	долгионоос	N;ABL;SG
тахих	тахисан	V;IND;PST
боргио	боргиогоор	N;INS;SG
гайхалтай	гайхлаа	N;VOC;SG
хэрэг	хэргээс	N;ABL;SG
гачигдал	гачигдлаар	N;INS;SG
худалдагч	худалдагчаар	N;INS;SG
ад	адаа	N;VOC;SG
чих	чихийг	N;ACC;SG
зочин	зочноор	N;INS;SG
эхлэл	эхлэлээ	N;VOC;SG
аялагч	аялагчаа	N;VOC;SG
тэнхлэг	тэнхлэгээ	N;VOC;SG
асуулт	асуултаас	N;ABL;SG
хяналт	хяналтаар	N;INS;SG
мөчир	мөчрийн	N;GEN;SG
сэдэл	сэдлээ	N;VOC;SG
хожуул	хожуулаар	N;INS;SG
мэх	мэхээ	N;VOC;SG
ажиллах	ажиллав	V;PRF;IND;PRS
бөгж	бөгжийг	N;ACC;SG
цуврал	цувралаа	N;VOC;SG
цэцэгжүүлэлт	цэцэгжүүлэлтийг	N;ACC;SG
драм	драмын	N;GEN;SG
коллеж	коллежийн	N;GEN;SG
загатнаа	загатнааг	N;ACC;SG
далан	далангаар	N;INS;SG
тууралт	тууралтыг	N;ACC;SG
гялтгануур	гялтгануураас	N;ABL;SG
ажилтан	ажилтнаар	N;INS;SG
холболт	холболтын	N;GEN;SG
хагарал	хагарлын	N;GEN;SG
иргэн	иргэнийг	N;ACC;SG
орлого	орлогоор	N;INS;SG
таглаа	таглаагаар	N;INS;SG
сүр	сүрээ	N;VOC;SG
нисгэгч	нисгэгчээр	N;INS;SG
нүүдэл	нүүдлээс	N;ABL;SG
гахай	гахайг	N;ACC;SG
буудлага	буудлагыг	N;ACC;SG
сайд	сайдаар	N;INS;SG
түгэх	түгчих	V;IMP;SG+PL;2
тогтоол	тогтоолоо	N;VOC;SG
толгой	толгойгоо	N;VOC;SG
бодол	бодлоос	N;ABL;SG
араа	араанаас	N;ABL;SG
тулаан	тулааныг	N;ACC;SG
хуулбар	хуулбараар	N;INS;SG
бичээч	бичээчийг	N;ACC;SG
татвар	татвараар	N;INS;SG
вальс	вальсаас	N;ABL;SG
шүүрэл	шүүрлийн	N;GEN;SG
агаар	агаараар	N;INS;SG
удиртгал	удиртгалаас	N;ABL;SG
ногт	ногтоор	N;INS;SG
хуульч	хуульчийн	N;GEN;SG
мухлаг	мухлагийг	N;ACC;SG
айлчлал	айлчлалыг	N;ACC;SG
гуалин	гуалинг	N;ACC;SG
хөгжимчин	хөгжимчнөөр	N;INS;SG
таглаа	таглааны	N;GEN;SG
шаналгаа	шаналгааны	N;GEN;SG
ноорог	нооргоор	N;INS;SG
видео	видеоны	N;GEN;SG
конус	конусаар	N;INS;SG
гүтгэлэг	гүтгэлгээр	N;INS;SG
бонд	бондоо	N;VOC;SG
уурхайчин	уурхайчнаа	N;VOC;SG
зүг	зүгээс	N;ABL;SG
хяналт	хяналтын	N;GEN;SG
бэлтгэл	бэлтгэлээр	N;INS;SG
танилцуулга	танилцуулгаар	N;INS;SG
төр	төрөөр	N;INS;SG
өргөрөг	өргөргөөс	N;ABL;SG
хавчлага	хавчлагаа	N;VOC;SG
наалдац	наалдцаар	N;INS;SG
мэх	мэхний	N;GEN;SG
хуваагдал	хуваагдлаар	N;INS;SG
хандив	хандиваар	N;INS;SG
хатаагч	хатаагчаар	N;INS;SG
зөн	зөнгөөр	N;INS;SG
тасалгаа	тасалгааны	N;GEN;SG
шат	шатыг	N;ACC;SG
үргэлжлэл	үргэлжлэлээр	N;INS;SG
чагнаал	чагнаалын	N;GEN;SG
хөших	хөшив	V;PRF;IND;PRS
харилцаа	харилцааны	N;GEN;SG
мөнгө	мөнгөнөөс	N;ABL;SG
сэтгэл	сэтгэлээс	N;ABL;SG
задрал	задралаар	N;INS;SG
багцаа	багцаагаар	N;INS;SG
чимэглэл	чимэглэлийг	N;ACC;SG
харвин	харвингийн	N;GEN;SG
ялгаа	ялгаагаа	N;VOC;SG
сүрдүүлэг	сүрдүүлгийг	N;ACC;SG
хорголж	хорголжоор	N;INS;SG
цикл	циклийн	N;GEN;SG
тэтгэмж	тэтгэмжийн	N;GEN;SG
чоно	чоноор	N;INS;SG
жад	жадны	N;GEN;SG
сувд	сувдын	N;GEN;SG
шугуй	шугуйгаар	N;INS;SG
танхим	танхимаа	N;VOC;SG
бичилт	бичилтийг	N;ACC;SG
хайгуул	хайгуулын	N;GEN;SG
хийлч	хийлчээ	N;VOC;SG
ажиллах	зулгаацгаа	V;IMP;PL;2;PRS
үрлэг	үрлэгээ	N;VOC;SG
шивнээ	шивнээг	N;ACC;SG
совин	совингоо	N;VOC;SG
хавч	хавчаар	N;INS;SG
чөмөг	чөмгөө	N;VOC;SG
найруулагч	найруулагчийн	N;GEN;SG
оосор	оосроор	N;INS;SG
хавтан	хавтангаар	N;INS;SG
эндүүрэл	эндүүрлээс	N;ABL;SG
видео	видеогоор	N;INS;SG
цэцэгжүүлэлт	цэцэгжүүлэлтээс	N;ABL;SG
чимэг	чимгээс	N;ABL;SG
сүсэг	сүсгээ	N;VOC;SG
тулаан	тулаанаас	N;ABL;SG
мэдрэмж	мэдрэмжийн	N;GEN;SG
байгууллага	байгууллагаар	N;INS;SG
цээж	цээжийг	N;ACC;SG
хөгжим	хөгжмөөс	N;ABL;SG
тариа	тарианы	N;GEN;SG
дутагдал	дутагдлын	N;GEN;SG
шөнө	шөнийг	N;ACC;SG
бөмбөг	бөмбөгөө	N;VOC;SG
өдөр	өдрийн	N;GEN;SG
эцэг	эцгийг	N;ACC;SG
шоргоолж	шоргоолжны	N;GEN;SG
онолч	онолчийн	N;GEN;SG
зулай	зулайг	N;ACC;SG
гадаргуу	гадаргуугаа	N;VOC;SG
мэрийлт	мэрийлтийн	N;GEN;SG
алт	алтаа	N;VOC;SG
тэсрэлт	тэсрэлтийн	N;GEN;SG
дулаарах	ажиллавал	V.CVB;LGSPEC03
алиалагч	алиалагчийн	N;GEN;SG
хайрцаг	хайрцгаас	N;ABL;SG
халим	халимаар	N;INS;SG
түгшүүр	түгшүүрийг	N;ACC;SG
холгодос	холгодсоо	N;VOC;SG
дуулга	дуулганаас	N;ABL;SG
багаж	багажаас	N;ABL;SG
прокурор	прокуророор	N;INS;SG
хөнөөл	хөнөөлийг	N;ACC;SG
марк	маркаар	N;INS;SG
хүлээс	хүлээсээ	N;VOC;SG
агуй	агуйг	N;ACC;SG
бутрал	бутралаас	N;ABL;SG
шулам	шулмаа	N;VOC;SG
давталт	давталтаа	N;VOC;SG
хүндлэл	хүндлэлийн	N;GEN;SG
жанжин	жанжнаас	N;ABL;SG
цээр	цээрээ	N;VOC;SG
ухагдахуун	ухагдахууны	N;GEN;SG
ботаник	ботаникаа	N;VOC;SG
жим	жимээс	N;ABL;SG
шүүмж	шүүмжийн	N;GEN;SG
архи	архинаас	N;ABL;SG
хуваагдагч	хуваагдагчаас	N;ABL;SG
өөдөс	өөдсийг	N;ACC;SG
фракц	фракцаас	N;ABL;SG
ёжлол	ёжлолыг	N;ACC;SG
жич	жичийг	N;ACC;SG
захиалагч	захиалагчийг	N;ACC;SG
мэргэжил	мэргэжлийн	N;GEN;SG
текст	текстээ	N;VOC;SG
түрэмгийлэл	түрэмгийллээр	N;INS;SG
шинэчлэл	шинэчлэлээ	N;VOC;SG
худалдаачин	худалдаачнаар	N;INS;SG
шингэлт	шингэлтээс	N;ABL;SG
тааз	таазнаас	N;ABL;SG
чимэглэл	чимэглэлийн	N;GEN;SG
хүйтэн	хүйтнээ	N;VOC;SG
зэвсэг	зэвсгийг	N;ACC;SG
чавга	чавгыг	N;ACC;SG
оператор	операторын	N;GEN;SG
амьтай	амины	N;GEN;SG
нахиа	нахиагаар	N;INS;SG
баримт	баримтаа	N;VOC;SG
гэдэс	гэдсээ	N;VOC;SG
ховоо	ховоогоо	N;VOC;SG
сал	салаар	N;INS;SG
урамшуулал	урамшууллыг	N;ACC;SG
лааз	лаазны	N;GEN;SG
арифметик	арифметикаар	N;INS;SG
удирдлага	удирдлагаас	N;ABL;SG
ашиг	ашгийг	N;ACC;SG
олборлолт	олборлолтыг	N;ACC;SG
захидал	захидлаас	N;ABL;SG
занга	зангаа	N;VOC;SG
доройтол	доройтлоо	N;VOC;SG
бохь	бохио	N;VOC;SG
эмгэнэл	эмгэнэлээс	N;ABL;SG
луу	луунаас	N;ABL;SG
зар	зарыг	N;ACC;SG
шөрмөс	шөрмөсөөр	N;INS;SG
төлөөлөгч	төлөөлөгчийг	N;ACC;SG
товчлол	товчлолоо	N;VOC;SG
ахлагч	ахлагчийн	N;GEN;SG
бамбар	бамбарыг	N;ACC;SG
зөвлөгч	зөвлөгчөөс	N;ABL;SG
хараал	хараалаас	N;ABL;SG
обой	обойгоос	N;ABL;SG
өсгий	өсгийг	N;ACC;SG
сүүдэр	сүүдрийг	N;ACC;SG
хуулбар	хуулбараас	N;ABL;SG
хардалт	хардалтыг	N;ACC;SG
зараа	зарааг	N;ACC;SG
өмгөөлөгч	өмгөөлөгчийг	N;ACC;SG
дэгдэлт	дэгдэлтийг	N;ACC;SG
үрчлээ	үрчлээгээ	N;VOC;SG
зар	зараа	N;VOC;SG
холбоо	холбоогоор	N;INS;SG
тариачин	тариачны	N;GEN;SG
амь	амины	N;GEN;SG
тангараг	тангаргаа	N;VOC;SG
ажиглалт	ажиглалтаа	N;VOC;SG
урвал	урвалын	N;GEN;SG
эхнэр	эхнэрээр	N;INS;SG
яам	яамнаас	N;ABL;SG
сэв	сэвийн	N;GEN;SG
анализ	анализаар	N;INS;SG
хөөс	хөөсийг	N;ACC;SG
эвдрэл	эвдрэлийг	N;ACC;SG
уут	уутаа	N;VOC;SG
нэр	нэрийн	N;GEN;SG
гаргалт	гаргалтаар	N;INS;SG
алга	алганы	N;GEN;SG
сонсох	сонсвол	V.CVB;LGSPEC03
яндан	яндангаас	N;ABL;SG
шар	шарын	N;GEN;SG
тохиргоо	тохиргооны	N;GEN;SG
зүрхтэй	зүрхний	N;GEN;SG
ашигтай	ашгаа	N;VOC;SG
ламп	лампыг	N;ACC;SG
эргэлзэл	эргэлзлээр	N;INS;SG
тэрслэгч	тэрслэгчээ	N;VOC;SG
талх	талхаа	N;VOC;SG
уцаар	уцаараас	N;ABL;SG
орой	оройгоор	N;INS;SG
харшил	харшлаас	N;ABL;SG
унага	унагыг	N;ACC;SG
эрсдэл	эрсдэлийг	N;ACC;SG
зочин	зочныг	N;ACC;SG
галзуурал	галзуурлын	N;GEN;SG
нас	насны	N;GEN;SG
зарчим	зарчмаас	N;ABL;SG
алт	алтнаас	N;ABL;SG
дизайнер	дизайнераа	N;VOC;SG
эмч	эмчийн	N;GEN;SG
сахал	сахлаар	N;INS;SG
мөргөлчин	мөргөлчнийг	N;ACC;SG
онош	оношийг	N;ACC;SG
тоглоом	тоглоомын	N;GEN;SG
тэмцээн	тэмцээнээс	N;ABL;SG
цооног	цооногоос	N;ABL;SG
тасалбар	тасалбараас	N;ABL;SG
гадар	гадраас	N;ABL;SG
оёдол	оёдлыг	N;ACC;SG
жолоо	жолоогоо	N;VOC;SG
алиалагч	алиалагчаар	N;INS;SG
пальто	пальтогоо	N;VOC;SG
им	имийн	N;GEN;SG
жор	жороо	N;VOC;SG
хурд	хурднаас	N;ABL;SG
хуримтлал	хуримтлалын	N;GEN;SG
үү	үүг	N;ACC;SG
хайгуул	хайгуулаа	N;VOC;SG
радио	радиог	N;ACC;SG
инженер	инженерийг	N;ACC;SG
эрдэс	эрдсээ	N;VOC;SG
ертөнц	ертөнцийн	N;GEN;SG
хотжих	хотожчих	V;IMP;SG+PL;2
иллэг	иллэгийн	N;GEN;SG
жаяг	жаягийн	N;GEN;SG
нөхөр	нөхрөөр	N;INS;SG
битүүлэг	битүүлгээр	N;INS;SG
үзүүлэн	үзүүлэнгээ	N;VOC;SG
өвгөн	өвгөнийг	N;ACC;SG
гийгүүлэгч	гийгүүлэгчийг	N;ACC;SG
сэтгүүл	сэтгүүлээ	N;VOC;SG
хохирол	хохирлыг	N;ACC;SG
түйвээн	түйвээнийг	N;ACC;SG
могой	могойгоор	N;INS;SG
бөөгнөрөл	бөөгнөрлөөс	N;ABL;SG
мөрдөлт	мөрдөлтөөр	N;INS;SG
цөөрөм	цөөрмийн	N;GEN;SG
цэнгэл	цэнгэлээр	N;INS;SG
продакшн	продакшнаа	N;VOC;SG
танилцуулга	танилцуулгаа	N;VOC;SG
мэргэ	мэргээ	N;VOC;SG
найз	найзаа	N;VOC;SG
цомог	цомгийн	N;GEN;SG
хэрэгцээ	хэрэгцээний	N;GEN;SG
зангаа	зангаагаар	N;INS;SG
сэдэл	сэдлээс	N;ABL;SG
долгио	долгионоос	N;ABL;SG
гачигдал	гачигдлаа	N;VOC;SG
шрифт	шрифтийн	N;GEN;SG
сорви	сорвиноос	N;ABL;SG
тэгшитгэл	тэгшитгэлийн	N;GEN;SG
диаметр	диаметрийг	N;ACC;SG
дараа	дараагаа	N;VOC;SG
сүнс	сүнсээс	N;ABL;SG
хавтас	хавтсыг	N;ACC;SG
тогтворжилт	тогтворжилтын	N;GEN;SG
худаг	худгаар	N;INS;SG
тохь	тохио	N;VOC;SG
ашиглалт	ашиглалтыг	N;ACC;SG
зохицуулагч	зохицуулагчаас	N;ABL;SG
шүхэр	шүхрээс	N;ABL;SG
зогсоц	зогсцыг	N;ACC;SG
цэцэг	цэцгийг	N;ACC;SG
янхан	янхныг	N;ACC;SG
тэнхлэг	тэнхлэгээр	N;INS;SG
хачирхалтай	хачирхлаа	N;VOC;SG
чөлөө	чөлөөнөөс	N;ABL;SG
хэмжээ	хэмжээнээс	N;ABL;SG
тунхаг	тунхгаас	N;ABL;SG
үзүүр	үзүүрээс	N;ABL;SG
суваг	сувгаас	N;ABL;SG
сургамж	сургамжаас	N;ABL;SG
гийчин	гийчнээр	N;INS;SG
сонирхогч	сонирхогчийг	N;ACC;SG
шохойжих	шохойжчих	V;IMP;SG+PL;2
наадам	наадмын	N;GEN;SG
итгэл	итгэлээ	N;VOC;SG
хөхрөх	хөхрөв	V;PRF;IND;PRS
авхуулах	ажиллацгаа	V;IMP;PL;2;PRS
үлгэр	үлгэрийн	N;GEN;SG
сонсох	сонсон	V;IND;PST
баатар	баатрын	N;GEN;SG
иргэн	иргэнээр	N;INS;SG
сөргөлдөөн	сөргөлдөөний	N;GEN;SG
шөл	шөлнөөс	N;ABL;SG
таатай	таанаас	N;ABL;SG
арш	аршаас	N;ABL;SG
хонь	хонийг	N;ACC;SG
код	кодын	N;GEN;SG
түрээслэгч	түрээслэгчийн	N;GEN;SG
амуу	амууг	N;ACC;SG
нийлэмж	нийлэмжээ	N;VOC;SG
танилцуулга	танилцуулгын	N;GEN;SG
ханцуй	ханцуйгаа	N;VOC;SG
сүрдүүлэг	сүрдүүлгээс	N;ABL;SG
хүчээр	хүчээр	N;INS;SG
заагч	заагчийн	N;GEN;SG
цацраг	цацрагийг	N;ACC;SG
ажиллах	ажилласан	V;IND;PST
дээс	дээсний	N;GEN;SG
фашизм	фашизмын	N;GEN;SG
шинж	шинжээс	N;ABL;SG
дайчилгаа	дайчилгааны	N;GEN;SG
хорио	хориог	N;ACC;SG
агуй	агуйнаас	N;ABL;SG
даяан	даяанаар	N;INS;SG
дарамт	дарамтын	N;GEN;SG
хүүрнэл	хүүрнэлийн	N;GEN;SG
байгууламж	байгууламжийн	N;GEN;SG
тариачин	тариачнаа	N;VOC;SG
жил	жилээ	N;VOC;SG
эдэлгээ	эдэлгээгээр	N;INS;SG
хийлч	хийлчээс	N;ABL;SG
харшил	харшлаа	N;VOC;SG
мяндас	мяндасны	N;GEN;SG
зөвлөгч	зөвлөгчөөр	N;INS;SG
нэмэлт	нэмэлтээс	N;ABL;SG
даруулгатай	даруулгыг	N;ACC;SG
дамар	дамрыг	N;ACC;SG
саа	саагаар	N;INS;SG
бүжигчин	бүжигчнээр	N;INS;SG
том	томоор	N;INS;SG
казино	казиногоо	N;VOC;SG
хадуур	хадуураар	N;INS;SG
гараа	гарааг	N;ACC;SG
рационализм	рационализмаа	N;VOC;SG
шинж	шинжийг	N;ACC;SG
залхуурал	залхуурлын	N;GEN;SG
сэлгээ	сэлгээг	N;ACC;SG
олборлолт	олборлолтоо	N;VOC;SG
нийгэмлэг	нийгэмлэгээ	N;VOC;SG
товчлол	товчлолоос	N;ABL;SG
баримт	баримтаас	N;ABL;SG
утаа	утаанаас	N;ABL;SG
хүндэтгэл	хүндэтгэлээс	N;ABL;SG
харилцуур	харилцуураа	N;VOC;SG
тэнцвэр	тэнцвэрийн	N;GEN;SG
пуужин	пуужингаар	N;INS;SG
шүвтэр	шүвтрээ	N;VOC;SG
аваар	аваараас	N;ABL;SG
өвчтөн	өвчтөнөөс	N;ABL;SG
гайхамшиг	гайхамшгаа	N;VOC;SG
боолт	боолтыг	N;ACC;SG
тогтоол	тогтоолыг	N;ACC;SG
цэнгэл	цэнгэлээ	N;VOC;SG
гоёл	гоёлыг	N;ACC;SG
тавилга	тавилгыг	N;ACC;SG
хамелеон	хамелеоноос	N;ABL;SG
сэлгээ	сэлгээгээ	N;VOC;SG
тусгаарлалт	тусгаарлалтыг	N;ACC;SG
эзлэгч	эзлэгчээс	N;ABL;SG
байнгын	байнгыг	N;ACC;SG
дэнлүү	дэнлүүгээр	N;INS;SG
эрдэмтэн	эрдэмтнээр	N;INS;SG
төлөөлөгч	төлөөлөгчийн	N;GEN;SG
суурь	сууриар	N;INS;SG
цуврал	цувралыг	N;ACC;SG
савлуур	савлуураа	N;VOC;SG
тууль	туулиа	N;VOC;SG
сам	самны	N;GEN;SG
жишиг	жишгээс	N;ABL;SG
тавилан	тавиланг	N;ACC;SG
обой	обойгоор	N;INS;SG
отряд	отрядоор	N;INS;SG
хувьсгагч	хувьсгагчаар	N;INS;SG
бүжигчин	бүжигчнийг	N;ACC;SG
талийгч	талийгчийг	N;ACC;SG
дов	довоор	N;INS;SG
зангаа	зангаанаас	N;ABL;SG
тээвэр	тээврээр	N;INS;SG
өсгөлт	өсгөлтөө	N;VOC;SG
саван	савангаа	N;VOC;SG
хөрөг	хөргийн	N;GEN;SG
дөнжөө	дөнжөө	N;VOC;SG
керамик	керамикаас	N;ABL;SG
академи	академиар	N;INS;SG
томилгоо	томилгоогоо	N;VOC;SG
зулгаах	зулгаавал	V.CVB;LGSPEC03
оёдолчин	оёдолчныг	N;ACC;SG
керамик	керамикийг	N;ACC;SG
бурхан	бурхныг	N;ACC;SG
таслалт	таслалтын	N;GEN;SG
өнгөлөх	өнгөлцгөө	V;IMP;PL;2;PRS
тавилан	тавилангаа	N;VOC;SG
дураараа	дураар	N;INS;SG
хүрхрээ	хүрхрээний	N;GEN;SG
магадлал	магадлалаар	N;INS;SG
хөгжимчин	хөгжимчнөө	N;VOC;SG
ах	ахын	N;GEN;SG
үүргэвч	үүргэвчний	N;GEN;SG
будаа	будаагаар	N;INS;SG
сүй	сүйгээр	N;INS;SG
устгал	устгалаа	N;VOC;SG
хөргөгч	хөргөгчийн	N;GEN;SG
товч	товчийг	N;ACC;SG
индүүдлэг	индүүдлэгээс	N;ABL;SG
төсөл	төслөөс	N;ABL;SG
зээтүү	зээтүүгээр	N;INS;SG
сойз	сойзыг	N;ACC;SG
оршил	оршлоос	N;ABL;SG
нөмрөг	нөмрөгөөр	N;INS;SG
элэгдэл	элэгдлээ	N;VOC;SG
дургүйцэл	дургүйцлээс	N;ABL;SG
осол	ослоос	N;ABL;SG
шаналал	шаналлын	N;GEN;SG
гарал	гарлаа	N;VOC;SG
бүсгүй	бүсгүйгээс	N;ABL;SG
эргүүлэг	эргүүлгийн	N;GEN;SG
яншуй	яншуйгаа	N;VOC;SG
мөрдлөг	мөрдлөгөөр	N;INS;SG
тархалт	тархалтыг	N;ACC;SG
амраг	амрагаа	N;VOC;SG
далайчин	далайчнаар	N;INS;SG
консул	консулын	N;GEN;SG
шүвтэр	шүвтрийг	N;ACC;SG
тагт	тагтаа	N;VOC;SG
өчил	өчлөөр	N;INS;SG
амт	амтыг	N;ACC;SG
бааз	баазын	N;GEN;SG
булчин	булчингаар	N;INS;SG
засварчин	засварчнаас	N;ABL;SG
итгэл	итгэлээр	N;INS;SG
гуалин	гуалингаас	N;ABL;SG
асар	асрыг	N;ACC;SG
холбоо	холбоогоо	N;VOC;SG
шидэлт	шидэлтээр	N;INS;SG
мөөг	мөөгний	N;GEN;SG
дүнз	дүнзийг	N;ACC;SG
эцэс	эцсийг	N;ACC;SG
ирмэг	ирмэгээс	N;ABL;SG
хувьсагч	хувьсагчийн	N;GEN;SG
шүүмжлэгч	шүүмжлэгчээ	N;VOC;SG
нуруу	нуруугаа	N;VOC;SG
харьцуулалт	харьцуулалтаас	N;ABL;SG
жишээ	жишээгээ	N;VOC;SG
үү	үүний	N;GEN;SG
ажиллах	ажиллачих	V;IMP;SG+PL;2
хэлцэл	хэлцлээ	N;VOC;SG
оргуул	оргуулаа	N;VOC;SG
эрэл	эрлээс	N;ABL;SG
семинар	семинарыг	N;ACC;SG
өргөлт	өргөлтөөр	N;INS;SG
анд	андаас	N;ABL;SG
хүүхэлдэй	хүүхэлдэйг	N;ACC;SG
атга	атгыг	N;ACC;SG
анхаарал	анхаарлыг	N;ACC;SG
хөдөлгөөн	хөдөлгөөнөөр	N;INS;SG
ухагдахуун	ухагдахууныг	N;ACC;SG
шүр	шүрийг	N;ACC;SG
дагавар	дагавраар	N;INS;SG
линз	линзийн	N;GEN;SG
ёгтлол	ёгтлолыг	N;ACC;SG
үргээгч	үргээгчээр	N;INS;SG
сүсэгтэн	сүсэгтнийг	N;ACC;SG
хязгаарлал	хязгаарлалаа	N;VOC;SG
эвсэл	эвслийг	N;ACC;SG
хөөс	хөөснөөс	N;ABL;SG
зовлон	зовлонг	N;ACC;SG
эрдэнэс	эрдэнэсийг	N;ACC;SG
дэвсгэр	дэвсгэрээс	N;ABL;SG
жолоо	жолоогоор	N;INS;SG
тор	торны	N;GEN;SG
завь	завиар	N;INS;SG
амралт	амралтаас	N;ABL;SG
илбэчин	илбэчний	N;GEN;SG
хучлага	хучлагаа	N;VOC;SG
мэргэжилтэн	мэргэжилтнээр	N;INS;SG
хорвоо	хорвоогоос	N;ABL;SG
чөлөөтэй	чөлөөгөөр	N;INS;SG
тоо	тооны	N;GEN;SG
шүр	шүрний	N;GEN;SG
хуримтлал	хуримтлалыг	N;ACC;SG
хөгжим	хөгжмийг	N;ACC;SG
ангилал	ангиллаас	N;ABL;SG
хүнд	хүндээс	N;ABL;SG
дохиур	дохиурын	N;GEN;SG
тогооч	тогоочоор	N;INS;SG
энгэр	энгэрийн	N;GEN;SG
аялал	аяллыг	N;ACC;SG
туйлын	туйлын	N;GEN;SG
дэлхий	дэлхийг	N;ACC;SG
жүжигчин	жүжигчнээ	N;VOC;SG
гурил	гурилаа	N;VOC;SG
дусал	дуслаар	N;INS;SG
ёроол	ёроолын	N;GEN;SG
тармуур	тармуураар	N;INS;SG
багс	багсыг	N;ACC;SG
давс	давснаас	N;ABL;SG
хаалга	хаалгаар	N;INS;SG
цацраг	цацрагаа	N;VOC;SG
сэв	сэвээр	N;INS;SG
янхан	янхнаа	N;VOC;SG
гашуудалтай	гашуудлаар	N;INS;SG
зардал	зардлын	N;GEN;SG
шээс	шээсийг	N;ACC;SG
жүжиг	жүжгээр	N;INS;SG
махчин	махчнаас	N;ABL;SG
гадарга	гадаргаас	N;ABL;SG
нислэг	нислэгээр	N;INS;SG
бэсрэг	бэсрэгийн	N;GEN;SG
найрууламж	найрууламжаар	N;INS;SG
үнэр	үнэрээ	N;VOC;SG
нөхцөл	нөхцөлөөр	N;INS;SG
яриа	яриагаар	N;INS;SG
няцаалт	няцаалтаас	N;ABL;SG
тээвэрлэлт	тээвэрлэлтээр	N;INS;SG
санхүүч	санхүүчээс	N;ABL;SG
гирвэших	гирвэшчих	V;IMP;SG+PL;2
халим	халимын	N;GEN;SG
түгжээ	түгжээний	N;GEN;SG
паспорт	паспортоо	N;VOC;SG
мөөг	мөөгөөр	N;INS;SG
бэлчээр	бэлчээрээр	N;INS;SG
сөнөөгч	сөнөөгчөө	N;VOC;SG
фракц	фракцаар	N;INS;SG
гараа	гараагаа	N;VOC;SG
хулгана	хулганаас	N;ABL;SG
цардас	цардсыг	N;ACC;SG
сорох	соёлжлоо	V;PRF;IND;PRS
ажиллах	зулгаачих	V;IMP;SG+PL;2
ором	ормоос	N;ABL;SG
атом	атомыг	N;ACC;SG
хэрэг	хэргийн	N;GEN;SG
тав	тавын	N;GEN;SG
ханцуй	ханцуйн	N;GEN;SG
арилжаа	арилжаанаас	N;ABL;SG
сэдэгч	сэдэгчийг	N;ACC;SG
онгод	онгодоос	N;ABL;SG
өвчин	өвчнөөр	N;INS;SG
хайлш	хайлшны	N;GEN;SG
драм	драмыг	N;ACC;SG
зээлдүүлэгч	зээлдүүлэгчийн	N;GEN;SG
хөлөг	хөлгөөс	N;ABL;SG
ороолт	ороолтыг	N;ACC;SG
трамвай	трамвайнаас	N;ABL;SG
эмэгчин	эмэгчнээр	N;INS;SG
тэг	тэгийг	N;ACC;SG
гачигдал	гачигдлыг	N;ACC;SG
мөнгө	мөнгөө	N;VOC;SG
хуурай	хуурайгаа	N;VOC;SG
тусгаарлалт	тусгаарлалтаа	N;VOC;SG
дургүйцэл	дургүйцлээр	N;INS;SG
хавар	хаврын	N;GEN;SG
аялга	аялгын	N;GEN;SG
цондон	цондонгийн	N;GEN;SG
бэлчээр	бэлчээрийг	N;ACC;SG
зодоон	зодооны	N;GEN;SG
мэдээ	мэдээгээр	N;INS;SG
хүслэн	хүслэнгээс	N;ABL;SG
нийлбэр	нийлбэрээр	N;INS;SG
өдөр	өдрийг	N;ACC;SG
дүрслэл	дүрслэлээ	N;VOC;SG
удирдлага	удирдлагыг	N;ACC;SG
тааз	таазыг	N;ACC;SG
сүсэгтэн	сүсэгтнээр	N;INS;SG
төгөл	төглийн	N;GEN;SG
маяг	маягийн	N;GEN;SG
чиргүүл	чиргүүлээр	N;INS;SG
гүтгэлэг	гүтгэлгээ	N;VOC;SG
угсралт	угсралтаар	N;INS;SG
шинэтгэл	шинэтгэлээ	N;VOC;SG
хавтас	хавтаснаас	N;ABL;SG
шарх	шархнаас	N;ABL;SG
заан	зааныг	N;ACC;SG
пуужин	пуужингаа	N;VOC;SG
дизайнер	дизайнераас	N;ABL;SG
егөөдөл	егөөдлөөс	N;ABL;SG
ээж	ээжийг	N;ACC;SG
загвар	загварын	N;GEN;SG
үржвэр	үржвэрээс	N;ABL;SG
хэрэм	хэрмээс	N;ABL;SG
төмөр	төмрөөр	N;INS;SG
фокус	фокусын	N;GEN;SG
үрлэг	үрлэгийн	N;GEN;SG
пуужин	пуужингаас	N;ABL;SG
бяслаг	бяслагийг	N;ACC;SG
боловсруулалт	боловсруулалтыг	N;ACC;SG
жишиг	жишгийн	N;GEN;SG
сэжиг	сэжгээр	N;INS;SG
хошин	хошинг	N;ACC;SG
төмөр	төмрөөс	N;ABL;SG
таамаг	таамгийг	N;ACC;SG
нисгэгч	нисгэгчээс	N;ABL;SG
индукц	индукцийг	N;ACC;SG
зэв	зэвийн	N;GEN;SG
бичвэр	бичвэрээ	N;VOC;SG
үнэлэмж	үнэлэмжээс	N;ABL;SG
давс	давсыг	N;ACC;SG
үйлчлэгч	үйлчлэгчийг	N;ACC;SG
давхарга	давхаргыг	N;ACC;SG
хүрээ	хүрээнээс	N;ABL;SG
саван	савангаас	N;ABL;SG
шураг	шургийг	N;ACC;SG
гялгар	гялгарыг	N;ACC;SG
санхүүч	санхүүчээ	N;VOC;SG
модернизм	модернизмоос	N;ABL;SG
тэнцвэр	тэнцвэрээ	N;VOC;SG
гомдол	гомдлоос	N;ABL;SG
академи	академиа	N;VOC;SG
сэргээлт	сэргээлтээр	N;INS;SG
угж	угжийг	N;ACC;SG
хөдөлмөр	хөдөлмөрөөр	N;INS;SG
найртай	найраас	N;ABL;SG
дадал	дадлаас	N;ABL;SG
ханш	ханшийг	N;ACC;SG
чавга	чавгаар	N;INS;SG
хөрөөдөх	хөрөөдсөн	V;IND;PST
жигтэй	жигийг	N;ACC;SG
уцаар	уцаараар	N;INS;SG
роман	романаар	N;INS;SG
зөрлөг	зөрлөгөөр	N;INS;SG
алдагдал	алдагдлаас	N;ABL;SG
цохилт	цохилтын	N;GEN;SG
асуулга	асуулгаас	N;ABL;SG
сахиус	сахиусаа	N;VOC;SG
робот	роботоо	N;VOC;SG
хүчтэй	хүчээ	N;VOC;SG
тунадас	тунадаснаас	N;ABL;SG
гахай	гахайнаас	N;ABL;SG
яриа	яриаг	N;ACC;SG
ваарчин	ваарчнаар	N;INS;SG
тусламж	тусламжийг	N;ACC;SG
хөрөөдөх	өвөрлөлөө	V;PRF;IND;PRS
квадрат	квадратаа	N;VOC;SG
тэлээ	тэлээг	N;ACC;SG
дэгдэлт	дэгдэлтийн	N;GEN;SG
элэгдэл	элэгдлийг	N;ACC;SG
хэвшил	хэвшлээр	N;INS;SG
өөх	өөхнөөс	N;ABL;SG
хөдлөл	хөдлөлөөс	N;ABL;SG
зээтүү	зээтүүгээ	N;VOC;SG
зүрхтэй	зүрхийг	N;ACC;SG
фронт	фронтын	N;GEN;SG
багш	багшийг	N;ACC;SG
харамсал	харамслын	N;GEN;SG
нум	нумнаас	N;ABL;SG
тэнгис	тэнгисээс	N;ABL;SG
уйтгар	уйтгарын	N;GEN;SG
эмэгтэйчүүд	харьтыг	N;ACC;SG
хуваарилалт	хуваарилалтын	N;GEN;SG
экватор	экватораар	N;INS;SG
хулмас	хулмасны	N;GEN;SG
жодоо	жодооноос	N;ABL;SG
өлсгөлөн	өлсгөлөнгөө	N;VOC;SG
дэлбэрэлт	дэлбэрэлтээ	N;VOC;SG
халбага	халбагаа	N;VOC;SG
үнэлгээ	үнэлгээнээс	N;ABL;SG
зуун	зуунаар	N;INS;SG
сорилго	сорилгын	N;GEN;SG
довцог	довцгийн	N;GEN;SG
чөлөө	чөлөөний	N;GEN;SG
зарлал	зарлалаас	N;ABL;SG
хэрэглэгч	хэрэглэгчээс	N;ABL;SG
намар	намраас	N;ABL;SG
намаг	намгаа	N;VOC;SG
нийлэмж	нийлэмжийн	N;GEN;SG
эргэлзээ	эргэлзээний	N;GEN;SG
хөхөвч	хөхөвчийг	N;ACC;SG
элч	элчээс	N;ABL;SG
чагт	чагтны	N;GEN;SG
мөхөөлдөс	мөхөөлдсийг	N;ACC;SG
эх	эхийг	N;ACC;SG
шүтэлцээ	шүтэлцээний	N;GEN;SG
тотем	тотемоос	N;ABL;SG
ирвэгэнэх	ирвэгэнэжээ	V;IND;PST
зорилго	зорилгоор	N;INS;SG
акт	актын	N;GEN;SG
бахархал	бахархлаас	N;ABL;SG
симфони	симфонио	N;VOC;SG
өрөө	өрөөгөөр	N;INS;SG
цэрэг	цэргийн	N;GEN;SG
зөгнөл	зөгнөлийн	N;GEN;SG
бариа	бариаг	N;ACC;SG
хандивлагч	хандивлагчаа	N;VOC;SG
шүүлтүүр	шүүлтүүрээр	N;INS;SG
шүршигч	шүршигчээ	N;VOC;SG
мөс	мөсөө	N;VOC;SG
агшилт	агшилтын	N;GEN;SG
сэлэм	сэлмээс	N;ABL;SG
майонез	майонезаар	N;INS;SG
алдаа	алдааг	N;ACC;SG
мандолин	мандолинаас	N;ABL;SG
жил	жилээс	N;ABL;SG
үнэ	үнээс	N;ABL;SG
бармен	барменээ	N;VOC;SG
борлуулалт	борлуулалтаар	N;INS;SG
болор	болрыг	N;ACC;SG
дүүжлүүр	дүүжлүүрээр	N;INS;SG
гэрч	гэрчээ	N;VOC;SG
логик	логикоос	N;ABL;SG
нягтаршил	нягтаршлаа	N;VOC;SG
зовлон	зовлонгоо	N;VOC;SG
солир	солирын	N;GEN;SG
бөмбөг	бөмбөгийг	N;ACC;SG
залгамжлал	залгамжлалыг	N;ACC;SG
хэмжээ	хэмжээгээ	N;VOC;SG
заан	заанаас	N;ABL;SG
гөлөг	гөлгөөр	N;INS;SG
зангилаа	зангилаагаа	N;VOC;SG
дараа	дарааг	N;ACC;SG
шаталт	шаталтыг	N;ACC;SG
уран	уранаас	N;ABL;SG
хором	хормын	N;GEN;SG
довтолгоо	довтолгооны	N;GEN;SG
им	имийг	N;ACC;SG
кофе	кофегоо	N;VOC;SG
лазер	лазераас	N;ABL;SG
оновчтой	оновчоо	N;VOC;SG
философи	философио	N;VOC;SG
өрц	өрцөөр	N;INS;SG
жанжин	жанжны	N;GEN;SG
шийдвэрлэгч	шийдвэрлэгчээр	N;INS;SG
орой	оройн	N;GEN;SG
сонирхогчийн	сонирхогчоо	N;VOC;SG
чийгшил	чийгшлээс	N;ABL;SG
нягтаршил	нягтаршлыг	N;ACC;SG
харшилдаан	харшилдааныг	N;ACC;SG
зовлон	зовлонгийн	N;GEN;SG
зайрмаг	зайрмагийг	N;ACC;SG
ээтийх	авхуулцгаа	V;IMP;PL;2;PRS
кино	киноноос	N;ABL;SG
тасалбар	тасалбараа	N;VOC;SG
түгэх	түгээцгээ	V;IMP;PL;2;PRS
гуйлгачин	гуйлгачнаар	N;INS;SG
оёдолчин	оёдолчноо	N;VOC;SG
гадуурхал	гадуурхлын	N;GEN;SG
барилга	барилгын	N;GEN;SG
хамар	хамраас	N;ABL;SG
сонирхол	сонирхлын	N;GEN;SG
хачирхалтай	хачирхлын	N;GEN;SG
хариуцлага	хариуцлагаас	N;ABL;SG
хясаа	хясаагаар	N;INS;SG
өгөгдөл	өгөгдлөө	N;VOC;SG
орц	орцыг	N;ACC;SG
түрээс	түрээсээ	N;VOC;SG
эрх	эрхийн	N;GEN;SG
дадлага	дадлагыг	N;ACC;SG
радиатор	радиаторын	N;GEN;SG
материализм	материализмаар	N;INS;SG
солбицох	солбицов	V;PRF;IND;PRS
цондон	цондонг	N;ACC;SG
капсул	капсулыг	N;ACC;SG
салаа	салаагаа	N;VOC;SG
тохироо	тохироогоор	N;INS;SG
судалгаа	судалгаагаар	N;INS;SG
курс	курсээ	N;VOC;SG
шинжилгээ	шинжилгээгээ	N;VOC;SG
үймээн	үймээнээс	N;ABL;SG
тив	тивээс	N;ABL;SG
урц	урцны	N;GEN;SG
зааварчилгаа	зааварчилгааны	N;GEN;SG
мэнгэ	мэнгэний	N;GEN;SG
хүчилтөрөгч	хүчилтөрөгчийн	N;GEN;SG
глюкоз	глюкозын	N;GEN;SG
товхимол	товхимлоо	N;VOC;SG
галзуурал	галзуурлаас	N;ABL;SG
хямдрал	хямдралын	N;GEN;SG
коллеж	коллежоос	N;ABL;SG
индекс	индексээр	N;INS;SG
торних	торнивол	V.CVB;LGSPEC03
зохиомж	зохиомжоор	N;INS;SG
тоормос	тоормосыг	N;ACC;SG
хайрс	хайрсыг	N;ACC;SG
ардчилал	ардчиллаар	N;INS;SG
шүүмжлэл	шүүмжлэлээр	N;INS;SG
залуур	залуураа	N;VOC;SG
уйтгартай	уйтгарын	N;GEN;SG
тэврэлт	тэврэлтийг	N;ACC;SG
шархлаа	шархлаанаас	N;ABL;SG
төмөр	төмрөө	N;VOC;SG
ирмэг	ирмэгээр	N;INS;SG
жараахай	жараахайнаас	N;ABL;SG
лавлах	лавлахаас	N;ABL;SG
чанар	чанарын	N;GEN;SG
тонуул	тонуулаар	N;INS;SG
үер	үерийн	N;GEN;SG
зангиа	зангианаас	N;ABL;SG
хэрчим	хэрчмээр	N;INS;SG
шүтээн	шүтээнээр	N;INS;SG
чичирхийлэл	чичирхийллээ	N;VOC;SG
аварга	аваргаас	N;ABL;SG
хүчил	хүчлээр	N;INS;SG
хэрчим	хэрчмээс	N;ABL;SG
сайд	сайдыг	N;ACC;SG
шийр	шийрээс	N;ABL;SG
шүр	шүрээр	N;INS;SG
горхи	горхиноос	N;ABL;SG
цэцэгжүүлэлт	цэцэгжүүлэлтээр	N;INS;SG
мангас	мангасыг	N;ACC;SG
баримтлал	баримтлалаа	N;VOC;SG
дайн	дайнаас	N;ABL;SG
зөвлөгөөн	зөвлөгөөнийг	N;ACC;SG
таргалалт	таргалалтаар	N;INS;SG
аав	ааваас	N;ABL;SG
нислэг	нислэгээ	N;VOC;SG
гийчин	гийчнээ	N;VOC;SG
шугуй	шугуйн	N;GEN;SG
сургууль	сургуулиа	N;VOC;SG
өмсгөл	өмсгөлөөс	N;ABL;SG
чих	чихээр	N;INS;SG
авс	авснаас	N;ABL;SG
шуурга	шуургаар	N;INS;SG
жуулчин	жуулчнаар	N;INS;SG
бөглөрөл	бөглөрлийг	N;ACC;SG
бугуй	бугуйгаа	N;VOC;SG
лааз	лаазнаас	N;ABL;SG
хувь	хувийг	N;ACC;SG
бичиг	бичгээ	N;VOC;SG
эрхэс	эрхсийн	N;GEN;SG
өгөгдөл	өгөгдлөөс	N;ABL;SG
нисгэгч	нисгэгчийн	N;GEN;SG
тармуур	тармуураас	N;ABL;SG
дүгнэлт	дүгнэлтээс	N;ABL;SG
дэлгэц	дэлгэцээр	N;INS;SG
төвлөрөл	төвлөрлийг	N;ACC;SG
цардуул	цардуулаар	N;INS;SG
төгөл	төглөөс	N;ABL;SG
цогцолбор	цогцолбороо	N;VOC;SG
сонсох	сонсчих	V;IMP;SG+PL;2
дэнс	дэнсний	N;GEN;SG
зөрчил	зөрчлөө	N;VOC;SG
эргэлзээ	эргэлзээг	N;ACC;SG
цардуул	цардуулыг	N;ACC;SG
амбиц	амбицаа	N;VOC;SG
ялгадас	ялгадсыг	N;ACC;SG
тусгал	тусгалаа	N;VOC;SG
зүтгэл	зүтгэлээс	N;ABL;SG
мэдрэмж	мэдрэмжээс	N;ABL;SG
цэнгүүн	цэнгүүнээ	N;VOC;SG
өвдөг	өвдгийг	N;ACC;SG
масштаб	масштабаар	N;INS;SG
заналхийлэл	заналхийллийг	N;ACC;SG
сорви	сорвио	N;VOC;SG
өмгөөлөл	өмгөөллөө	N;VOC;SG
зуслан	зуслангаар	N;INS;SG
модернизм	модернизмоо	N;VOC;SG
толгойлогч	толгойлогчийг	N;ACC;SG
дүрвэгчид	дүрвэгчийн	N;GEN;SG
хандив	хандиваа	N;VOC;SG
сүйтгэгч	сүйтгэгчийн	N;GEN;SG
шүлт	шүлтийг	N;ACC;SG
босуул	босуулын	N;GEN;SG
авьяастан	авьяастнаас	N;ABL;SG
банзал	банзлыг	N;ACC;SG
тохиролцоо	тохиролцооноос	N;ABL;SG
бие	биеэс	N;ABL;SG
хими	химиэс	N;ABL;SG
гүйлт	гүйлтээр	N;INS;SG
чоно	чононы	N;GEN;SG
загасчин	загасчныг	N;ACC;SG
эмэгтэйчүүд	харьтын	N;GEN;SG
уулзалт	уулзалтаа	N;VOC;SG
зүүлт	зүүлтээс	N;ABL;SG
фонт	фонтыг	N;ACC;SG
утас	утсаар	N;INS;SG
зурах	зурчих	V;IMP;SG+PL;2
нас	насаар	N;INS;SG
шувуу	шувууны	N;GEN;SG
сэрэмжлүүлэг	сэрэмжлүүлгээр	N;INS;SG
нягтшил	нягтшилыг	N;ACC;SG
сампин	сампингийн	N;GEN;SG
тааз	таазаар	N;INS;SG
мэндлэх	мэндлэв	V;PRF;IND;PRS
сорох	сорцгоо	V;IMP;PL;2;PRS
нууц	нууцыг	N;ACC;SG
зуун	зуунаа	N;VOC;SG
аавынх	ааваар	N;INS;SG
хандивлагч	хандивлагчийг	N;ACC;SG
сэлгээ	сэлгээний	N;GEN;SG
элч	элчээ	N;VOC;SG
тойрог	тойргоор	N;INS;SG
бариул	бариулаар	N;INS;SG
болзол	болзлыг	N;ACC;SG
буурцаг	буурцгаас	N;ABL;SG
уянга	уянгаар	N;INS;SG
гарал	гарлын	N;GEN;SG
торт	торноос	N;ABL;SG
үрэл	үрлээс	N;ABL;SG
аймаг	аймгаас	N;ABL;SG
цацаг	цацгийн	N;GEN;SG
журам	журмыг	N;ACC;SG
хангамж	хангамжаар	N;INS;SG
цалин	цалингаа	N;VOC;SG
цамц	цамцаар	N;INS;SG
хаягдал	хаягдлаар	N;INS;SG
санал	саналаас	N;ABL;SG
хөөрөл	хөөрлийн	N;GEN;SG
худаг	худгийн	N;GEN;SG
жолооч	жолоочоос	N;ABL;SG
ороолт	ороолтоо	N;VOC;SG
гуйлга	гуйлгыг	N;ACC;SG
болор	болроос	N;ABL;SG
төөрөгдөл	төөрөгдлөөр	N;INS;SG
залбирал	залбирлаас	N;ABL;SG
эмэгчин	эмэгчнээ	N;VOC;SG
төв	төвөөс	N;ABL;SG
урлал	урлалаар	N;INS;SG
дарцаг	дарцгийн	N;GEN;SG
микробиологи	микробиологийн	N;GEN;SG
дууль	дуулиар	N;INS;SG
акт	актаа	N;VOC;SG
дараалал	дарааллаар	N;INS;SG
сандал	сандлаас	N;ABL;SG
театр	театраа	N;VOC;SG
дүрвэгч	дүрвэгчээ	N;VOC;SG
цохиур	цохиураа	N;VOC;SG
хэрэгтэн	хэрэгтнээ	N;VOC;SG
далайц	далайцаа	N;VOC;SG
үдэшлэг	үдэшлэгийн	N;GEN;SG
шүршүүр	шүршүүрийн	N;GEN;SG
нийлэмж	нийлэмжийг	N;ACC;SG
хигээс	хигээснээс	N;ABL;SG
дун	дунгаа	N;VOC;SG
эрэгчин	эрэгчнээ	N;VOC;SG
зайрмаг	зайрмагаа	N;VOC;SG
ноён	ноёны	N;GEN;SG
хулмас	хулмасаа	N;VOC;SG
хуудас	хуудсаа	N;VOC;SG
даяан	даяанаа	N;VOC;SG
илгээгч	илгээгчээс	N;ABL;SG
томьёо	томьёогоо	N;VOC;SG
орогнох	орогновол	V.CVB;LGSPEC03
сахиус	сахиуснаас	N;ABL;SG
хун	хунгаас	N;ABL;SG
тээрэм	тээрмээ	N;VOC;SG
эзэмшигч	эзэмшигчийг	N;ACC;SG
үеэл	үеэлээ	N;VOC;SG
нимбэг	нимбэгээ	N;VOC;SG
дээс	дээсээ	N;VOC;SG
хорсол	хорслоор	N;INS;SG
зөвлөгөө	зөвлөгөөнөөс	N;ABL;SG
зүлэг	зүлгээ	N;VOC;SG
мэдүүлэг	мэдүүлгийг	N;ACC;SG
гүтгэлэг	гүтгэлгийг	N;ACC;SG
шуурга	шуурганаас	N;ABL;SG
удиртгал	удиртгалын	N;GEN;SG
семинар	семинараас	N;ABL;SG
манан	манангийн	N;GEN;SG
амралт	амралтын	N;GEN;SG
цикл	циклээ	N;VOC;SG
гариг	гаригийн	N;GEN;SG
гахай	гахайгаа	N;VOC;SG
даруул	даруулаа	N;VOC;SG
цэцэрлэг	цэцэрлэгээс	N;ABL;SG
прокурор	прокуророос	N;ABL;SG
хэрэгцээ	хэрэгцээнээс	N;ABL;SG
донсолгоо	донсолгоогоо	N;VOC;SG
хязгаар	хязгаараар	N;INS;SG
чичирхийлэл	чичирхийллээс	N;ABL;SG
эрдэмтэн	эрдэмтнээс	N;ABL;SG
хасалт	хасалтаар	N;INS;SG
дууль	дуулиас	N;ABL;SG
семинар	семинараа	N;VOC;SG
дүрэм	дүрмээ	N;VOC;SG
давхраа	давхрааны	N;GEN;SG
илгээмж	илгээмжээс	N;ABL;SG
дэгдэлт	дэгдэлтээ	N;VOC;SG
уялдаа	уялдаагаар	N;INS;SG
түгжээ	түгжээгээр	N;INS;SG
янжуур	янжуураар	N;INS;SG
хясаа	хясаанаас	N;ABL;SG
түгэх	түгжээ	V;IND;PST
дэмжлэг	дэмжлэгийн	N;GEN;SG
тохиргоо	тохиргооноос	N;ABL;SG
гийгүүлэгч	гийгүүлэгчээс	N;ABL;SG
аймшигтай	аймшгаар	N;INS;SG
эргүү	эргүүгийн	N;GEN;SG
нийтлэл	нийтлэлээр	N;INS;SG
үүл	үүлийг	N;ACC;SG
дохиур	дохиураас	N;ABL;SG
ноён	ноёноо	N;VOC;SG
бааш	баашаа	N;VOC;SG
нийлбэр	нийлбэрийг	N;ACC;SG
бүлэг	бүлгээр	N;INS;SG
трансформатор	трансформатораар	N;INS;SG
тэмцээн	тэмцээнийг	N;ACC;SG
автобус	автобуснаас	N;ABL;SG
вальс	вальсаа	N;VOC;SG
цуваа	цуваагаа	N;VOC;SG
язгууртан	язгууртнаас	N;ABL;SG
хэрүүл	хэрүүлийн	N;GEN;SG
хувьсгал	хувьсгалаар	N;INS;SG
философи	философийг	N;ACC;SG
ялагч	ялагчийг	N;ACC;SG
тээрэм	тээрмээр	N;INS;SG
батжилт	батжилтыг	N;ACC;SG
агуулах	агуулахаа	N;VOC;SG
залбирал	залбирлын	N;GEN;SG
мужаан	мужаанаас	N;ABL;SG
хэрчдэс	хэрчдэсээ	N;VOC;SG
хулуу	хулуугаа	N;VOC;SG
шархлаа	шархлааны	N;GEN;SG
шинэтгэл	шинэтгэлээс	N;ABL;SG
хөнөөл	хөнөөлөөр	N;INS;SG
дулаарах	ажиллалаа	V;PRF;IND;PRS
хорголж	хорголжийг	N;ACC;SG
найртай	найраар	N;INS;SG
сэжиг	сэжгийг	N;ACC;SG
боржин	боржингоо	N;VOC;SG
пайз	пайзыг	N;ACC;SG
соёл	соёлоо	N;VOC;SG
дүүжин	дүүжингээр	N;INS;SG
хөтөлбөр	хөтөлбөрийн	N;GEN;SG
гуйлгачин	гуйлгачнаас	N;ABL;SG
булингартай	булингараас	N;ABL;SG
хошуучлагч	хошуучлагчаас	N;ABL;SG
гологдол	гологдлоос	N;ABL;SG
мөчлөг	мөчлөгийг	N;ACC;SG
үнэмшил	үнэмшлээс	N;ABL;SG
хариулт	хариултыг	N;ACC;SG
бэрхшээл	бэрхшээлээр	N;INS;SG
халамж	халамжийг	N;ACC;SG
нотолгоо	нотолгооны	N;GEN;SG
үеэл	үеэлийн	N;GEN;SG
өөрчлөл	өөрчлөлөө	N;VOC;SG
тогтолцоо	тогтолцооны	N;GEN;SG
оператор	операторыг	N;ACC;SG
ёроол	ёроолоор	N;INS;SG
хирс	хирсийн	N;GEN;SG
өгүүлэгдэхүүн	өгүүлэгдэхүүнээр	N;INS;SG
хоног	хоногоо	N;VOC;SG
цардас	цардаснаас	N;ABL;SG
хурдасгуур	хурдасгуурыг	N;ACC;SG
аймшигтай	аймшгийн	N;GEN;SG
өчил	өчлөө	N;VOC;SG
яншуй	яншуйн	N;GEN;SG
хавсралт	хавсралтыг	N;ACC;SG
хэлэхүй	хэлэхүйн	N;GEN;SG
хориг	хоригоос	N;ABL;SG
найр	найраа	N;VOC;SG
оноо	оноогоор	N;INS;SG
шүүгээ	шүүгээг	N;ACC;SG
гэрч	гэрчээр	N;INS;SG
ур	урыг	N;ACC;SG
тариур	тариурын	N;GEN;SG
хамтрал	хамтралыг	N;ACC;SG
цохих	цохицгоо	V;IMP;PL;2;PRS
хэвлий	хэвлийн	N;GEN;SG
дүүргэлт	дүүргэлтээс	N;ABL;SG
тэвхдэх	тэвхэдвэл	V.CVB;LGSPEC03
мэрийлт	мэрийлтээ	N;VOC;SG
гомдол	гомдлоор	N;INS;SG
махлаг	махлагаа	N;VOC;SG
архитектур	архитектураар	N;INS;SG
зангилаа	зангилааны	N;GEN;SG
орогнох	товойлоо	V;PRF;IND;PRS
дарга	даргаас	N;ABL;SG
хун	хунгаа	N;VOC;SG
бэлхүүс	бэлхүүсээс	N;ABL;SG
тохуу	тохуунаас	N;ABL;SG
шивээс	шивээсээр	N;INS;SG
чадвар	чадварын	N;GEN;SG
зэрэглэл	зэрэглэлээр	N;INS;SG
шийр	шийрээр	N;INS;SG
тунадас	тунадасны	N;GEN;SG
архитектур	архитектурын	N;GEN;SG
амьжиргаа	амьжиргаагаа	N;VOC;SG
сэнс	сэнсээс	N;ABL;SG
сонирхол	сонирхлоос	N;ABL;SG
мөлжлөг	мөлжлөгөө	N;VOC;SG
ээж	ээжийн	N;GEN;SG
ховил	ховилоос	N;ABL;SG
хими	химийг	N;ACC;SG
үе	үеийн	N;GEN;SG
хүзүү	хүзүүг	N;ACC;SG
айдас	айдсаас	N;ABL;SG
эзэмшигч	эзэмшигчээ	N;VOC;SG
үйлчлүүлэгч	үйлчлүүлэгчийн	N;GEN;SG
үер	үерээр	N;INS;SG
сархад	сархдаар	N;INS;SG
захирамж	захирамжаа	N;VOC;SG
загас	загасаар	N;INS;SG
толгойлогч	толгойлогчоос	N;ABL;SG
агшилт	агшилтаа	N;VOC;SG
заль	залийн	N;GEN;SG
маск	маскаа	N;VOC;SG
хулгана	хулганыг	N;ACC;SG
үсэглэл	үсэглэлээр	N;INS;SG
ой	ойгоор	N;INS;SG
дүүжлүүр	дүүжлүүрээ	N;VOC;SG
үр	үрээ	N;VOC;SG
аюул	аюулаа	N;VOC;SG
ялагдал	ялагдлыг	N;ACC;SG
хөтөч	хөтчийг	N;ACC;SG
цагцгай	цагцгайгаар	N;INS;SG
салтаа	салтааг	N;ACC;SG
гэгээрэл	гэгээрлээс	N;ABL;SG
урвагч	урвагчаа	N;VOC;SG
бүргэд	бүргэдээс	N;ABL;SG
тааз	таазаа	N;VOC;SG
битүүлэг	битүүлгээ	N;VOC;SG
